,Transaction Number,Transaction Date,Transaction Type,Transaction Description,Debit Amount,Credit Amount,Balance,Category,Location City,Location Country
0,1,25/07/2022,BP,SAVE THE CHANGE,3.11,,541.43,Savings,Nottingham,Uk
1,2,25/07/2022,DEB,LIDL GB  NOTTINGHA,15.02,,544.54,Groceries,Nottingham,Uk
2,3,25/07/2022,DEB,NON-GBP PURCH FEE,0.5,,559.56,Others,Nottingham,Uk
3,4,25/07/2022,DEB,NON-GBP TRANS FEE,0.37,,560.06,Others,Nottingham,Uk
4,5,25/07/2022,DEB,TRAVELIUM LLC,12.59,,560.43,,,
5,6,25/07/2022,DEB,Audible UK,7.99,,573.02,Entertainment,Nottingham,Uk
6,7,25/07/2022,FPO,MISS D WU,25.0,,581.01,Services,Nottingham,Uk
7,8,25/07/2022,DEB,SAINSBURYS S/MKTS,35.57,,606.01,Groceries,Nottingham,Uk
8,9,22/07/2022,DEB,LIDL GB  NOTTINGHA,18.21,,641.58,Groceries,Nottingham,Uk
9,10,22/07/2022,DEB,Amazon.co.uk*VK6IN,13.51,,659.79,Amazon,Nottingham,Uk
10,11,22/07/2022,FPO,MR J DOME,175.0,,673.3,Services,Nottingham,Uk
11,12,21/07/2022,FPO,MISS D WU,35.0,,848.3,Services,Nottingham,Uk
12,13,20/07/2022,FPO,TRADING212UK,200.0,,883.3,Investment,Nottingham,Uk
13,14,20/07/2022,FPI,SHEILA SMITH,,390.0,1083.3,Supplementary Income,Nottingham,Uk
14,15,20/07/2022,BP,SAVE THE CHANGE,0.65,,693.3,Savings,Nottingham,Uk
15,16,19/07/2022,DEB,THE TERRACE CAFE M,31.35,,693.95,Dine Out,,
16,17,19/07/2022,BP,SAVE THE CHANGE,1.6,,725.3,Savings,Nottingham,Uk
17,18,18/07/2022,DEB,The Corinthian,7.4,,726.9,Dine Out,Nottingham,Uk
18,19,18/07/2022,DEB,The Corinthian,4.6,,734.3,Dine Out,Nottingham,Uk
19,20,18/07/2022,DEB,TIGERMILK EVENTS,4.5,,738.9,Entertainment,Plymouth,Uk
20,21,18/07/2022,DEB,UBER   *TRIP,11.9,,743.4,Travel,Plymouth,Uk
21,22,18/07/2022,DD,VIRGIN MEDIA PYMTS,56.25,,755.3,Bills,Nottingham,Uk
22,23,18/07/2022,DD,O2,17.95,,811.55,Other Shopping,Nottingham,Uk
23,24,18/07/2022,BP,SAVE THE CHANGE,2.4,,829.5,Savings,Nottingham,Uk
24,25,18/07/2022,CPT,LNK COOPERATIVE PL,40.0,,831.9,Cash,Plymouth,Uk
25,26,18/07/2022,DEB,COSMIC KITCHEN LIM,75.8,,871.9,Home Improvement,Nottingham,Uk
26,27,18/07/2022,DEB,TESCO STORE 3033,20.0,,947.7,Groceries,Plymouth,Uk
27,28,18/07/2022,DEB,CROWNE PLAZA,10.0,,967.7,Hotels,Plymouth,Uk
28,29,18/07/2022,DEB,EAST MIDS RAILWAY,213.0,,977.7,Travel,Plymouth,Uk
29,30,18/07/2022,DEB,AMZNMktplace,26.99,,1190.7,Amazon,Nottingham,Uk
30,31,18/07/2022,DEB,TESCO STORE 3033,22.1,,1217.69,Groceries,Plymouth,Uk
31,32,18/07/2022,DEB,SumUp  *Taxi first,8.0,,1239.79,Travel,Plymouth,Uk
32,33,15/07/2022,DEB,Amazon.co.uk*ST7ZE,42.01,,1247.79,Amazon,Nottingham,Uk
33,34,15/07/2022,DEB,ASPIRE CAFE,2.7,,1289.8,Dine Out,Nottingham,Uk
34,35,15/07/2022,FPI,WU,,27.0,1292.5,Supplementary Income,Nottingham,Uk
35,36,15/07/2022,BP,SAVE THE CHANGE,1.43,,1265.5,Savings,Nottingham,Uk
36,37,14/07/2022,DEB,UBER   *TRIP,5.66,,1266.93,Travel,Nottingham,Uk
37,38,14/07/2022,DEB,UBER   *TRIP,5.38,,1272.59,Travel,Nottingham,Uk
38,39,14/07/2022,DEB,MEDINA CONTINENTAL,4.53,,1277.97,Dine Out,Nottingham,Uk
39,40,14/07/2022,BP,SAVE THE CHANGE,1.01,,1282.5,Savings,Nottingham,Uk
40,41,13/07/2022,DEB,HPI INSTANT INK UK,4.49,,1283.51,Other Shopping,Nottingham,Uk
41,42,13/07/2022,DEB,CAFE TERRAZZO,3.5,,1288.0,Dine Out,Nottingham,Uk
42,43,13/07/2022,BP,SAVE THE CHANGE,0.08,,1291.5,Savings,Nottingham,Uk
43,44,12/07/2022,FPO,CAPEWELL WINDOW CL,30.0,,1291.58,Home Improvement,Nottingham,Uk
44,45,12/07/2022,DEB,AMZNMktplace,12.99,,1321.58,Amazon,Nottingham,Uk
45,46,12/07/2022,DEB,AMZNMktplace,9.93,,1334.57,Amazon,Nottingham,Uk
46,47,12/07/2022,BP,SAVE THE CHANGE,0.28,,1344.5,Savings,Nottingham,Uk
47,48,11/07/2022,DEB,LIDL GB  NOTTINGHA,47.84,,1344.78,Groceries,Nottingham,Uk
48,49,11/07/2022,DEB,UBER   *TRIP,4.88,,1392.62,Travel,Nottingham,Uk
49,50,11/07/2022,BP,SAVE THE CHANGE,1.16,,1397.5,Savings,Nottingham,Uk
50,51,11/07/2022,DEB,UBER   *TRIP,9.69,,1398.66,Travel,Nottingham,Uk
51,52,11/07/2022,DEB,UBER   *TRIP,7.48,,1408.35,Travel,Nottingham,Uk
52,53,11/07/2022,DEB,Subway 26377 Corne,6.89,,1415.83,Dine Out,Nottingham,Uk
53,54,11/07/2022,DEB,UBER   *TRIP,1.0,,1422.72,Travel,Nottingham,Uk
54,55,08/07/2022,FPI,Zoe Zappa,,325.0,1423.72,Supplementary Income,Nottingham,Uk
55,56,08/07/2022,DEB,DOSA N CHUTNEY,34.78,,1098.72,Dine Out,Nottingham,Uk
56,57,08/07/2022,BGC,UNIV OF NOTTINGHAM,,351.08,1133.5,Travel Reimbursement,Nottingham,Uk
57,58,07/07/2022,BP,SAVE THE CHANGE,0.77,,782.42,Savings,Nottingham,Uk
58,59,06/07/2022,DEB,Hotel on Booking.c,196.24,,783.19,Hotels,Nottingham,Uk
59,60,06/07/2022,DEB,AMZNMktplace,6.99,,979.43,Amazon,Nottingham,Uk
60,61,06/07/2022,BP,SAVE THE CHANGE,0.26,,986.42,Savings,Nottingham,Uk
61,62,05/07/2022,DEB,AMZNMktplace,15.99,,986.68,Amazon,Nottingham,Uk
62,63,05/07/2022,DEB,AMZNMktplace,2.75,,1002.67,Amazon,Nottingham,Uk
63,64,04/07/2022,DEP,CLUB LLOYDS WAIVED,,3.0,1005.42,Supplementary Income,Nottingham,Uk
64,65,04/07/2022,PAY,CLUB LLOYDS FEE,3.0,,1002.42,Bills,Nottingham,Uk
65,66,04/07/2022,FPI,O CONNOR CAROL,,10.0,1005.42,Supplementary Income,Nottingham,Uk
66,67,04/07/2022,BP,SAVE THE CHANGE,0.63,,995.42,Savings,Nottingham,Uk
67,68,04/07/2022,FPO,PAULINA PIPPEN,280.0,,996.05,Safety Deposit Return,,
68,69,04/07/2022,DEB,AMZNMktplace,27.99,,1276.05,Amazon,Nottingham,Uk
69,70,01/07/2022,,INTEREST (GROSS),,0.56,1304.04,Interest,Nottingham,Uk
70,71,01/07/2022,DEB,TROPICAL SUMMER FE,240.38,,1303.48,Entertainment,Plymouth,Uk
71,72,01/07/2022,DEB,SumUp  *LTP,6.0,,1543.86,Services,Nottingham,Uk
72,73,01/07/2022,DD,BARCLAYS UK MTGES,981.71,,1549.86,Bills,Nottingham,Uk
73,74,01/07/2022,DD,NOTTM CITY COUNC,112.0,,2531.57,Bills,Nottingham,Uk
74,75,01/07/2022,DD,OCTOPUS ENERGY,100.0,,2643.57,Bills,Nottingham,Uk
75,76,01/07/2022,DD,SEVERN TRENT WATER,43.95,,2743.57,Bills,Nottingham,Uk
76,77,01/07/2022,SO,ESAVINGS ACCOUNT,300.0,,2787.52,Savings,Nottingham,Uk
77,78,01/07/2022,BP,SAVE THE CHANGE,0.17,,3087.52,Savings,Nottingham,Uk
78,79,01/07/2022,BGC,UNIV OF NOTTINGHAM,,44.32,3087.69,Supplementary Income,Nottingham,Uk
79,80,30/06/2022,DEB,LIDL GB  NOTTINGHA,8.83,,3043.37,Groceries,Nottingham,Uk
80,81,29/06/2022,DEB,Amazon.co.uk*2Y0SX,229.0,,3052.2,Amazon,Nottingham,Uk
81,82,29/06/2022,FPO,TRADING212UK,1000.0,,3281.2,Investment,Nottingham,Uk
82,83,29/06/2022,DD,THE GYM LTD,19.99,,4281.2,Fitness,Nottingham,Uk
83,84,29/06/2022,BP,SAVE THE CHANGE,0.21,,4301.19,Savings,Nottingham,Uk
84,85,29/06/2022,BGC,UNIV OF NOTTINGHAM,,3748.52,4301.4,Paycheck,Nottingham,Uk
85,86,28/06/2022,DEB,LIDL GB  NOTTINGHA,6.79,,552.88,Groceries,Nottingham,Uk
86,87,28/06/2022,BP,SAVE THE CHANGE,2.0,,559.67,Savings,Nottingham,Uk
87,88,27/06/2022,CPT,LNK TESCO HK R NOT,50.0,,561.67,Cash,Nottingham,Uk
88,89,27/06/2022,DEB,LIDL GB NOTTINGHAM,22.09,,611.67,Groceries,Nottingham,Uk
89,90,27/06/2022,DEB,POUNDLAND LTD 1718,14.25,,633.76,Groceries,Nottingham,Uk
90,91,27/06/2022,DEB,UBER   *TRIP,5.78,,648.01,Travel,,
91,92,27/06/2022,DEB,IZ *LTD GROUP LIMI,4.93,,653.79,Home Improvement,Nottingham,Uk
92,93,27/06/2022,DEB,GREGGS PLC,3.95,,658.72,Dine Out,,
93,94,27/06/2022,BP,SAVE THE CHANGE,3.26,,662.67,Savings,Nottingham,Uk
94,95,27/06/2022,DEB,HEAVENLY DESSERTS,11.9,,665.93,Dine Out,Nottingham,Uk
95,96,27/06/2022,DEB,LIDL GB  NOTTINGHA,13.06,,677.83,Groceries,Nottingham,Uk
96,97,24/06/2022,DEB,PIE MINISTER,41.2,,690.89,Dine Out,Nottingham,Uk
97,98,24/06/2022,DEB,BELL INN,14.09,,732.09,Dine Out,Nottingham,Uk
98,99,24/06/2022,DEB,CAFE TERRAZZO,3.5,,746.18,Dine Out,Nottingham,Uk
99,100,24/06/2022,DEB,Audible UK,7.99,,749.68,Entertainment,Nottingham,Uk
100,101,24/06/2022,DEB,PIE MINISTER,,8.17,757.67,Supplementary Income,Nottingham,Uk
101,102,23/06/2022,BP,SAVE THE CHANGE,1.26,,749.5,Savings,Nottingham,Uk
102,103,22/06/2022,DEB,DOMINO'S PIZZA,9.99,,750.76,Dine Out,,
103,104,22/06/2022,DEB,LIDL GB NOTTINGHAM,5.25,,760.75,Groceries,Nottingham,Uk
104,105,22/06/2022,DEB,CAFE TERRAZZO,3.5,,766.0,Dine Out,Nottingham,Uk
105,106,22/06/2022,BP,SAVE THE CHANGE,1.09,,769.5,Savings,Nottingham,Uk
106,107,21/06/2022,DEB,UBER   *TRIP,6.59,,770.59,Travel,,
107,108,21/06/2022,DEB,NON-GBP TRANS FEE,0.06,,777.18,Others,Nottingham,Uk
108,109,21/06/2022,DEB,ROMA TERMINI SELF,2.32,,777.24,Travel,Roma,Italy
109,110,21/06/2022,BP,SAVE THE CHANGE,0.92,,779.56,Savings,Nottingham,Uk
110,111,20/06/2022,DEB,DOSA N CHUTNEY,41.2,,780.48,Dine Out,Nottingham,Uk
111,112,20/06/2022,FPO,PAULINA PIPPEN,4.52,,821.68,Food Shopping,,
112,113,20/06/2022,FPO,MISS D WU,11.0,,826.2,Services,Nottingham,Uk
113,114,20/06/2022,FPO,TRADING212UK,200.0,,837.2,Investment,Nottingham,Uk
114,115,20/06/2022,FPI,SHEILA SMITH,,390.0,1037.2,Supplementary Income,Nottingham,Uk
115,116,20/06/2022,DEB,NON-GBP TRANS FEE,0.44,,647.2,Others,Nottingham,Uk
116,117,20/06/2022,DEB,CHEF EXPRESS S.P.A,14.88,,647.64,Dine Out,Roma,Italy
117,118,20/06/2022,BP,SAVE THE CHANGE,1.72,,662.52,Savings,Nottingham,Uk
118,119,20/06/2022,DEB,NON-GBP TRANS FEE,0.57,,664.24,Others,Nottingham,Uk
119,120,20/06/2022,DEB,MS* CASASANTASOFIA,19.27,,664.81,Services,Nottingham,Uk
120,121,20/06/2022,DEB,NON-GBP TRANS FEE,0.37,,684.08,Others,Nottingham,Uk
121,122,20/06/2022,DEB,Pizza Forum,12.47,,684.45,Dine Out,Roma,Italy
122,123,20/06/2022,DEB,AMZNMktplace,23.0,,696.92,Amazon,Nottingham,Uk
123,124,20/06/2022,DEB,NON-GBP TRANS FEE,0.46,,719.92,Others,Nottingham,Uk
124,125,20/06/2022,DEB,BUDDY ITALIAN REST,15.54,,720.38,Dine Out,Roma,Italy
125,126,17/06/2022,DD,VIRGIN MEDIA PYMTS,56.25,,735.92,Bills,Nottingham,Uk
126,127,17/06/2022,BP,SAVE THE CHANGE,1.26,,792.17,Savings,Nottingham,Uk
127,128,16/06/2022,DEB,NON-GBP TRANS FEE,0.76,,793.43,Others,Nottingham,Uk
128,129,16/06/2022,DEB,UBER   *TRIP,25.57,,794.19,Travel,Roma,Italy
129,130,16/06/2022,DEB,NON-GBP TRANS FEE,0.57,,819.76,Others,Nottingham,Uk
130,131,16/06/2022,DEB,UBER *TRIP HELP.UB,19.17,,820.33,Travel,Roma,Italy
131,132,16/06/2022,DD,O2,18.01,,839.5,Other Shopping,Nottingham,Uk
132,133,15/06/2022,BP,SAVE THE CHANGE,0.51,,857.51,Savings,Nottingham,Uk
133,134,14/06/2022,DEB,NON-GBP TRANS FEE,5.11,,858.02,Others,Nottingham,Uk
134,135,14/06/2022,DEB,POSTE ITALIANE,171.0,,863.13,Others,Nottingham,Uk
135,136,14/06/2022,DEB,HPI INSTANT INK UK,4.49,,1034.13,Other Shopping,Nottingham,Uk
136,137,14/06/2022,BP,SAVE THE CHANGE,0.51,,1038.62,Savings,Nottingham,Uk
137,138,13/06/2022,DEB,EAST MIDS RAILWAY,56.7,,1039.13,Travel,Roma,Italy
138,139,13/06/2022,DEB,WH SMITH,8.79,,1095.83,Other Shopping,Nottingham,Uk
139,140,13/06/2022,BP,SAVE THE CHANGE,4.3,,1104.62,Savings,Nottingham,Uk
140,141,13/06/2022,DEB,ASIANA HYPERMARKET,60.83,,1108.92,Groceries,Nottingham,Uk
141,142,13/06/2022,DEB,LIDL GB NOTTINGHAM,34.12,,1169.75,Groceries,Nottingham,Uk
142,143,13/06/2022,DEB,UBER* TRIP,7.01,,1203.87,Travel,,
143,144,13/06/2022,CPT,LNK NOTTINGHAM RAI,30.0,,1210.88,Cash,Nottingham,Uk
144,145,13/06/2022,DEB,UBER   *TRIP,7.51,,1240.88,Travel,,
145,146,13/06/2022,DEB,AMZNMktplace,5.55,,1248.39,Amazon,Nottingham,Uk
146,147,13/06/2022,FPO,MISS D WU,29.0,,1253.94,Services,Nottingham,Uk
147,148,13/06/2022,DEB,DOMINO'S PIZZA - H,,9.99,1282.94,Supplementary Income,Nottingham,Uk
148,149,10/06/2022,FPO,MISS D WU,16.0,,1272.95,Services,Nottingham,Uk
149,150,10/06/2022,DEB,LIDL GB  NOTTINGHA,11.43,,1288.95,Groceries,Nottingham,Uk
150,151,10/06/2022,DEB,CAFE TERRAZZO,2.25,,1300.38,Dine Out,Nottingham,Uk
151,152,09/06/2022,BP,SAVE THE CHANGE,0.97,,1302.63,Savings,Nottingham,Uk
152,153,08/06/2022,DEB,Subway 32610 Midla,13.78,,1303.6,Dine Out,Nottingham,Uk
153,154,08/06/2022,DEB,CAFE TERRAZZO,2.25,,1317.38,Dine Out,Nottingham,Uk
154,155,07/06/2022,BP,SAVE THE CHANGE,2.04,,1319.63,Savings,Nottingham,Uk
155,156,06/06/2022,DEP,CLUB LLOYDS WAIVED,,3.0,1321.67,Amazon,Nottingham,Uk
156,157,06/06/2022,PAY,CLUB LLOYDS FEE,3.0,,1318.67,Bills,Nottingham,Uk
157,158,06/06/2022,DEB,AMZNMktplace,9.99,,1321.67,Supplementary Income,Nottingham,Uk
158,159,06/06/2022,DEB,PRIMARK,38.3,,1331.66,Clothes,,
159,160,06/06/2022,DEB,BLEND COFFEE HOUSE,18.45,,1369.96,Dine Out,Nottingham,Uk
160,161,06/06/2022,DEB,Murat food centre,13.81,,1388.41,Groceries,Nottingham,Uk
161,162,06/06/2022,DEB,HEAVENLY DESSERTS,4.41,,1402.22,Dine Out,Nottingham,Uk
162,163,06/06/2022,DEB,BLEND COFFEE HOUSE,,3.25,1406.63,Supplementary Income,Nottingham,Uk
163,164,06/06/2022,BP,SAVE THE CHANGE,2.76,,1403.38,Savings,Nottingham,Uk
164,165,06/06/2022,DEB,WHITE ROSE TRADING,29.05,,1406.14,Clothes,,
165,166,06/06/2022,DEB,PIE MINISTER,23.0,,1435.19,Dine Out,Nottingham,Uk
166,167,06/06/2022,DEB,CINEWORLD NOT CP,19.98,,1458.19,Entertainment,Nottingham,Uk
167,168,06/06/2022,DEB,LIDL GB NOTTINGHAM,16.37,,1478.17,Groceries,Nottingham,Uk
168,169,06/06/2022,DEB,CLOUD9 PURSUITS LT,10.0,,1494.54,Entertainment,Reading,Uk
169,170,06/06/2022,DEB,DOMINO'S PIZZA,9.99,,1504.54,Dine Out,,
170,171,06/06/2022,DEB,DOMINO'S PIZZA,9.99,,1514.53,Dine Out,,
171,172,06/06/2022,DEB,DOMINO'S PIZZA,9.99,,1524.52,Dine Out,,
172,173,06/06/2022,DEB,Amazon.co.uk*2G6K0,6.98,,1534.51,Amazon,Nottingham,Uk
173,174,06/06/2022,DEB,DOMINO'S PIZZA,1.64,,1541.49,Dine Out,,
174,175,06/06/2022,DEB,LIDL GB  NOTTINGHA,9.0,,1543.13,Groceries,Nottingham,Uk
175,176,01/06/2022,,INTEREST (GROSS),,0.56,1552.13,Interest,Nottingham,Uk
176,177,01/06/2022,DEB,CAFE TERRAZZO,4.25,,1551.57,Dine Out,Nottingham,Uk
177,178,01/06/2022,DD,BARCLAYS UK MTGES,981.71,,1555.82,Bills,Nottingham,Uk
178,179,01/06/2022,DD,NOTTM CITY COUNC,112.0,,2537.53,Bills,Nottingham,Uk
179,180,01/06/2022,DD,OCTOPUS ENERGY,100.0,,2649.53,Bills,Nottingham,Uk
180,181,01/06/2022,DD,SEVERN TRENT WATER,43.97,,2749.53,Bills,Nottingham,Uk
181,182,01/06/2022,SO,ESAVINGS ACCOUNT,300.0,,2793.5,Savings,Nottingham,Uk
182,183,31/05/2022,BP,SAVE THE CHANGE,1.71,,3093.5,Savings,Nottingham,Uk
183,184,30/05/2022,DEB,13th Element,35.5,,3095.21,Dine Out,Nottingham,Uk
184,185,30/05/2022,DEB,ORIENTAL MART HYDR,16.49,,3130.71,Groceries,Nottingham,Uk
185,186,30/05/2022,DEB,IZ *WHITE ROSE TRA,12.0,,3147.2,Clothes,,
186,187,30/05/2022,DEB,THE GYM LIMITED,10.0,,3159.2,Fitness,Nottingham,Uk
187,188,30/05/2022,DEB,HUI LAU SHAN,9.8,,3169.2,Dine Out,Nottingham,Uk
188,189,30/05/2022,DEB,POUNDLAND LTD 1718,1.5,,3179.0,Groceries,Nottingham,Uk
189,190,30/05/2022,FPO,TRADING212UK,1100.0,,3180.5,Investment,Nottingham,Uk
190,191,30/05/2022,BP,SAVE THE CHANGE,1.89,,4280.5,Savings,Nottingham,Uk
191,192,30/05/2022,BGC,UNIV OF NOTTINGHAM,,3748.92,4282.39,Paycheck,Nottingham,Uk
192,193,30/05/2022,FPO,MISS D WU,26.0,,533.47,Services,Nottingham,Uk
193,194,30/05/2022,DEB,BACHATA SUENO,24.0,,559.47,Entertainment,Nottingham,Uk
194,195,30/05/2022,DEB,LIDL GB  NOTTINGHA,11.58,,583.47,Groceries,Nottingham,Uk
195,196,30/05/2022,DEB,Amazon.co.uk*2G8AO,5.99,,595.05,Amazon,Nottingham,Uk
196,197,27/05/2022,DEB,AMZNMktplace,55.58,,601.04,Amazon,Nottingham,Uk
197,198,27/05/2022,DEB,LIDL GB NOTTINGHAM,31.9,,656.62,Groceries,Nottingham,Uk
198,199,27/05/2022,DEB,UBER   *TRIP,5.06,,688.52,Travel,,
199,200,27/05/2022,BP,SAVE THE CHANGE,1.03,,693.58,Savings,Nottingham,Uk
200,201,26/05/2022,CPT,LNK TESCO NO RA RD,50.0,,694.61,Cash,Nottingham,Uk
201,202,26/05/2022,DEB,LIDL GB  NOTTINGHA,6.47,,744.61,Groceries,Nottingham,Uk
202,203,26/05/2022,DEB,CAFE TERRAZZO,2.5,,751.08,Dine Out,Nottingham,Uk
203,204,26/05/2022,BP,SAVE THE CHANGE,0.53,,753.58,Savings,Nottingham,Uk
204,205,25/05/2022,DEB,LIDL GB NOTTINGHAM,16.83,,754.11,Groceries,Nottingham,Uk
205,206,25/05/2022,DEB,AMZNMktplace,6.99,,770.94,Amazon,Nottingham,Uk
206,207,25/05/2022,DEB,CAFE TERRAZZO,2.65,,777.93,Dine Out,Nottingham,Uk
207,208,25/05/2022,FPO,TRADING212UK,200.0,,780.58,Investment,Nottingham,Uk
208,209,25/05/2022,FPI,PAULINA PIPPEN,,325.0,980.58,Supplementary Income,Nottingham,Uk
209,210,25/05/2022,BP,SAVE THE CHANGE,0.71,,655.58,Savings,Nottingham,Uk
210,211,24/05/2022,DEB,LIDL GB  NOTTINGHA,5.3,,656.29,Groceries,Nottingham,Uk
211,212,24/05/2022,DEB,Audible UK,7.99,,661.59,Entertainment,Nottingham,Uk
212,213,24/05/2022,BP,SAVE THE CHANGE,0.31,,669.58,Savings,Nottingham,Uk
213,214,23/05/2022,DEB,POUNDLAND LTD 1726,16.0,,669.89,Groceries,Nottingham,Uk
214,215,23/05/2022,DEB,TESCO STORE 2960,15.69,,685.89,Groceries,,
215,216,23/05/2022,DEB,ALADDINS BIKES,120.0,,701.58,Other Shopping,Nottingham,Uk
216,217,23/05/2022,BP,SAVE THE CHANGE,1.37,,821.58,Savings,Nottingham,Uk
217,218,23/05/2022,DEB,IZ *WHITE ROSE TRA,12.5,,822.95,Clothes,,
218,219,23/05/2022,DEB,TESCO STORES 6430,2.75,,835.45,Groceries,,
219,220,23/05/2022,CPT,LNK SAINSBURYS BAN,40.0,,838.2,Cash,,
220,221,20/05/2022,FPO,MISS D WU,15.0,,878.2,Services,Nottingham,Uk
221,222,20/05/2022,DEB,Kaya Food Centre,6.38,,893.2,Groceries,Nottingham,Uk
222,223,20/05/2022,DEB,ALADDINS BIKES,22.0,,899.58,Other Shopping,Nottingham,Uk
223,224,20/05/2022,FPO,MISS D WU,22.0,,921.58,Services,Nottingham,Uk
224,225,20/05/2022,FPO,TRADING212UK,300.0,,943.58,Investment,Nottingham,Uk
225,226,20/05/2022,FPI,SHEILA SMITH,,380.0,1243.58,Supplementary Income,Nottingham,Uk
226,227,20/05/2022,BP,SAVE THE CHANGE,1.36,,863.58,Savings,Nottingham,Uk
227,228,19/05/2022,DEB,AMZNMktplace,33.02,,864.94,Amazon,Nottingham,Uk
228,229,19/05/2022,DEB,Amazon.co.uk*255RJ,14.99,,897.96,Amazon,Nottingham,Uk
229,230,19/05/2022,DEB,LIDL GB  NOTTINGHA,4.63,,912.95,Groceries,Nottingham,Uk
230,231,19/05/2022,BP,SAVE THE CHANGE,1.32,,917.58,Savings,Nottingham,Uk
231,232,18/05/2022,DEB,ORIENTAL MART HYDR,26.16,,918.9,Groceries,Nottingham,Uk
232,233,18/05/2022,DEB,IZ *WHITE ROSE TRA,10.0,,945.06,Clothes,,
233,234,18/05/2022,DEB,AMZNMktplace,2.87,,955.06,Amazon,Nottingham,Uk
234,235,18/05/2022,DEB,CAFE TERRAZZO,2.65,,957.93,Dine Out,Nottingham,Uk
235,236,18/05/2022,BP,SAVE THE CHANGE,0.85,,960.58,Savings,Nottingham,Uk
236,237,17/05/2022,DEB,Amazon.co.uk*257UG,12.15,,961.43,Amazon,Nottingham,Uk
237,238,17/05/2022,DD,VIRGIN MEDIA PYMTS,25.5,,973.58,Bills,Nottingham,Uk
238,239,17/05/2022,BP,SAVE THE CHANGE,0.98,,999.08,Savings,Nottingham,Uk
239,240,16/05/2022,DEB,NATIONAL MERCH,30.0,,1000.06,Clothes,,
240,241,16/05/2022,DEB,HEAVENLY DESSERTS,11.34,,1030.06,Dine Out,Nottingham,Uk
241,242,16/05/2022,DEB,HEAVENLY DESSERTS,4.68,,1041.4,Dine Out,Nottingham,Uk
242,243,16/05/2022,DD,O2,17.95,,1046.08,Other Shopping,Nottingham,Uk
243,244,16/05/2022,BP,SAVE THE CHANGE,3.17,,1064.03,Savings,Nottingham,Uk
244,245,16/05/2022,DEB,SAINSBURYS S/MKTS,35.8,,1067.2,Groceries,,
245,246,16/05/2022,DEB,DOSA N CHUTNEY,32.2,,1103.0,Dine Out,Nottingham,Uk
246,247,16/05/2022,DEB,Amazon.co.uk*259S0,7.99,,1135.2,Amazon,Nottingham,Uk
247,248,16/05/2022,DEB,LIDL GB  NOTTINGHA,15.84,,1143.19,Groceries,Nottingham,Uk
248,249,16/05/2022,DEB,Amazon.co.uk*255B9,10.99,,1159.03,Amazon,Nottingham,Uk
249,250,16/05/2022,DEB,ALADDINS BIKES,6.0,,1170.02,Other Shopping,Nottingham,Uk
250,251,13/05/2022,DEB,HPI INSTANT INK UK,4.49,,1176.02,Other Shopping,,
251,252,13/05/2022,DEB,Subway 32610 Midla,11.48,,1180.51,Dine Out,Nottingham,Uk
252,253,13/05/2022,DEB,LIDL GB NOTTINGHAM,7.54,,1191.99,Groceries,Nottingham,Uk
253,254,13/05/2022,DEB,DERBY MED CAFE,3.5,,1199.53,Dine Out,Derby,Uk
254,255,13/05/2022,FPO,TRADING212UK,500.0,,1203.03,Investment,Nottingham,Uk
255,256,13/05/2022,TFR,R LAWRENCE,,300.0,1703.03,Supplementary Income,Nottingham,Uk
256,257,12/05/2022,BP,SAVE THE CHANGE,0.5,,1403.03,Savings,Nottingham,Uk
257,258,12/05/2022,BGC,NCC TRADE CRED NEW,,150.0,1403.53,Supplementary Income,Nottingham,Uk
258,259,11/05/2022,DEB,UBER   *TRIP,4.0,,1253.53,Travel,,
259,260,11/05/2022,DEB,DERBY MED CAFE,3.5,,1257.53,Dine Out,Derby,Uk
260,261,11/05/2022,BP,SAVE THE CHANGE,0.59,,1261.03,Savings,Nottingham,Uk
261,262,10/05/2022,FPO,MISS D WU,13.0,,1261.62,Services,Nottingham,Uk
262,263,10/05/2022,DEB,RAJAH FOOD STORE L,20.41,,1274.62,Groceries,Nottingham,Uk
263,264,09/05/2022,BP,SAVE THE CHANGE,2.25,,1295.03,Savings,Nottingham,Uk
264,265,09/05/2022,DEB,MASALA JUNCTION,47.98,,1297.28,Dine Out,Nottingham,Uk
265,266,09/05/2022,DEB,LIDL GB  NOTTINGHA,14.01,,1345.26,Groceries,Nottingham,Uk
266,267,09/05/2022,DEB,LIDL GB  NOTTINGHA,5.85,,1359.27,Groceries,Nottingham,Uk
267,268,09/05/2022,FPI,SHEILA SMITH,,50.0,1365.12,Supplementary Income,Nottingham,Uk
268,269,06/05/2022,DEB,HEAVENLY DESSERTS,10.26,,1315.12,Dine Out,Nottingham,Uk
269,270,06/05/2022,DEB,CAFE TERRAZZO,6.0,,1325.38,Dine Out,Nottingham,Uk
270,271,06/05/2022,DEB,CAFE TERRAZZO,2.65,,1331.38,Dine Out,Nottingham,Uk
271,272,06/05/2022,BP,SAVE THE CHANGE,1.46,,1334.03,Savings,Nottingham,Uk
272,273,05/05/2022,DEB,AMZN Mktp US*1363Y,22.7,,1335.49,Amazon,Nottingham,Uk
273,274,05/05/2022,DEB,AMZNMktplace,43.77,,1358.19,Amazon,Nottingham,Uk
274,275,05/05/2022,DEB,LIDL GB  NOTTINGHA,8.57,,1401.96,Groceries,Nottingham,Uk
275,276,05/05/2022,DEB,DERBY MED CAFE,3.5,,1410.53,Dine Out,Derby,Uk
276,277,05/05/2022,DD,OCTOPUS ENERGY,100.0,,1414.03,Bills,Nottingham,Uk
277,278,04/05/2022,DEP,CLUB LLOYDS WAIVED,,3.0,1514.03,Supplementary Income,Nottingham,Uk
278,279,04/05/2022,PAY,CLUB LLOYDS FEE,3.0,,1511.03,Bills,Nottingham,Uk
279,280,04/05/2022,DD,NOTTM CITY COUNC,112.0,,1514.03,Bills,Nottingham,Uk
280,281,04/05/2022,BP,SAVE THE CHANGE,0.42,,1626.03,Savings,Nottingham,Uk
281,282,03/05/2022,,INTEREST (GROSS),,0.57,1626.45,Interest,Nottingham,Uk
282,283,03/05/2022,FPO,MISS D WU,23.0,,1625.88,Services,Nottingham,Uk
283,284,03/05/2022,DEB,LIDL GB  NOTTINGHA,12.58,,1648.88,Groceries,Nottingham,Uk
284,285,03/05/2022,FPO,MISS D WU,21.0,,1661.46,Services,Nottingham,Uk
285,286,03/05/2022,TFR,R LAWRENCE,,230.66,1682.46,Supplementary Income,Nottingham,Uk
286,287,03/05/2022,DD,BARCLAYS UK MTGES,981.71,,1451.8,Bills,Nottingham,Uk
287,288,03/05/2022,DD,SEVERN TRENT WATER,41.89,,2433.51,Bills,Nottingham,Uk
288,289,03/05/2022,SO,ESAVINGS ACCOUNT,300.0,,2475.4,Savings,Nottingham,Uk
289,290,03/05/2022,BP,SAVE THE CHANGE,3.99,,2775.4,Savings,Nottingham,Uk
290,291,03/05/2022,DEB,ALDI,37.27,,2779.39,Groceries,,
291,292,03/05/2022,DEB,AMZNMktplace,28.65,,2816.66,Amazon,Nottingham,Uk
292,293,03/05/2022,DEB,ORIENTAL MART HYDR,12.8,,2845.31,Groceries,Nottingham,Uk
293,294,03/05/2022,DEB,STARBUCKS,8.3,,2858.11,Dine Out,,
294,295,03/05/2022,DEB,KFC NOTTINGHAM,1.49,,2866.41,Dine Out,Nottingham,Uk
295,296,03/05/2022,DEB,SQ *NOTTINGHAM BAC,10.0,,2867.9,Entertainment,Nottingham,Uk
296,297,03/05/2022,DEB,CONFETTI CONSTELLA,5.5,,2877.9,Home Improvement,Nottingham,Uk
297,298,03/05/2022,DEB,CONFETTI CONSTELLA,3.5,,2883.4,Home Improvement,Nottingham,Uk
298,299,29/04/2022,DEB,DERBY MED CAFE,3.5,,2886.9,Dine Out,Derby,Uk
299,300,28/04/2022,FPO,TRADING212UK,1100.0,,2890.4,Investment,Nottingham,Uk
300,301,28/04/2022,BP,SAVE THE CHANGE,2.44,,3990.4,Savings,Nottingham,Uk
301,302,28/04/2022,BGC,UNIV OF NOTTINGHAM,,3748.93,3992.84,Paycheck,Nottingham,Uk
302,303,27/04/2022,DEB,Amazon.co.uk*2P60A,18.02,,243.91,Amazon,Nottingham,Uk
303,304,27/04/2022,DEB,DOSA N CHUTNEY,13.4,,261.93,Dine Out,Nottingham,Uk
304,305,27/04/2022,DEB,LIDL GB NOTTINGHAM,8.65,,275.33,Groceries,Nottingham,Uk
305,306,27/04/2022,DEB,AMZNMktplace,4.99,,283.98,Amazon,Nottingham,Uk
306,307,27/04/2022,DEB,DERBY MED CAFE,3.5,,288.97,Dine Out,Derby,Uk
307,308,27/04/2022,BP,SAVE THE CHANGE,0.99,,292.47,Savings,Nottingham,Uk
308,309,26/04/2022,DEB,AMZNMktplace,41.01,,293.46,Amazon,Nottingham,Uk
309,310,26/04/2022,BP,SAVE THE CHANGE,0.7,,334.47,Savings,Nottingham,Uk
310,311,25/04/2022,DEB,DOSA N CHUTNEY,14.8,,335.17,Dine Out,Nottingham,Uk
311,312,25/04/2022,DEB,TESCO STORES 5653,10.5,,349.97,Groceries,,
312,313,25/04/2022,BP,SAVE THE CHANGE,2.74,,360.47,Savings,Nottingham,Uk
313,314,25/04/2022,DEB,WORTH THE WEIGHT L,27.0,,363.21,Clothes,,
314,315,25/04/2022,DEB,HEAVENLY DESSERTS,15.35,,390.21,Dine Out,Nottingham,Uk
315,316,25/04/2022,DEB,Audible UK,7.99,,405.56,Entertainment,Nottingham,Uk
316,317,25/04/2022,FPO,MISS D WU,13.0,,413.55,Services,Nottingham,Uk
317,318,25/04/2022,DEB,TESCO STORE 2960,31.82,,426.55,Groceries,,
318,319,25/04/2022,DEB,ORIENTAL MART HYDR,16.69,,458.37,Groceries,Nottingham,Uk
319,320,25/04/2022,CPT,LNK TESCO LONG ROW,40.0,,475.06,Cash,Nottingham,Uk
320,321,25/04/2022,FPO,TAMBA TAM,13.0,,515.06,Services,Nottingham,Uk
321,322,22/04/2022,DEB,AMZNMktplace,22.89,,528.06,Amazon,Nottingham,Uk
322,323,22/04/2022,DEB,Amazon.co.uk*2P3K6,20.24,,550.95,Amazon,Nottingham,Uk
323,324,22/04/2022,DEB,LIDL GB  NOTTINGHA,11.28,,571.19,Groceries,Nottingham,Uk
324,325,21/04/2022,FPO,TRADING212UK,200.0,,582.47,Investment,Nottingham,Uk
325,326,21/04/2022,FPI,PAULINA PIPPEN,,320.0,782.47,Supplementary Income,Nottingham,Uk
326,327,21/04/2022,BP,SAVE THE CHANGE,0.34,,462.47,Savings,Nottingham,Uk
327,328,20/04/2022,DEB,CINEWORLD NOT CP,19.98,,462.81,Entertainment,Nottingham,Uk
328,329,20/04/2022,DEB,HEAVENLY DESSERTS,4.68,,482.79,Dine Out,Nottingham,Uk
329,330,20/04/2022,FPO,TRADING212UK,206.96,,487.47,Investment,Nottingham,Uk
330,331,20/04/2022,FPI,SHEILA SMITH,,380.0,694.43,Supplementary Income,Nottingham,Uk
331,332,20/04/2022,DD,O2,17.95,,314.43,Other Shopping,Nottingham,Uk
332,333,20/04/2022,BP,SAVE THE CHANGE,2.24,,332.38,Savings,Nottingham,Uk
333,334,19/04/2022,DEB,J D SPORTS PLC,85.0,,334.62,Other Shopping,,
334,335,19/04/2022,DEB,LAS IGUANAS,35.06,,419.62,Dine Out,Nottingham,Uk
335,336,19/04/2022,DEB,AMZNMktplace,23.95,,454.68,Amazon,Nottingham,Uk
336,337,19/04/2022,DEB,Elenas Patisserie,15.25,,478.63,Services,Nottingham,Uk
337,338,19/04/2022,DEB,TESCO STORES 5653,11.5,,493.88,Groceries,,
338,339,19/04/2022,DD,VIRGIN MEDIA PYMTS,25.5,,505.38,Bills,Nottingham,Uk
339,340,19/04/2022,BP,SAVE THE CHANGE,2.85,,530.88,Savings,Nottingham,Uk
340,341,19/04/2022,DEB,THE NED LUDD,6.95,,533.73,Dine Out,Nottingham,Uk
341,342,19/04/2022,DEB,HEAVENLY DESSERTS,6.39,,540.68,Dine Out,Nottingham,Uk
342,343,19/04/2022,DEB,AMZNMktplace,46.99,,547.07,Amazon,Nottingham,Uk
343,344,19/04/2022,DEB,LIDL GB  NOTTINGHA,23.79,,594.06,Groceries,Nottingham,Uk
344,345,19/04/2022,DEB,GetYourGuide UK Lt,,4.5,617.85,Supplementary Income,Nottingham,Uk
345,346,19/04/2022,DEB,SUTTON COLDFIELD A,8.4,,613.35,Travel,Birmingham,Uk
346,347,19/04/2022,DEB,SUTTON COLDFIELD A,5.3,,621.75,Travel,Birmingham,Uk
347,348,19/04/2022,DEB,IZ *WHITE ROSE TRA,11.85,,627.05,Clothes,,
348,349,19/04/2022,DEB,AMZNMktplace,9.99,,638.9,Amazon,Nottingham,Uk
349,350,14/04/2022,DEB,HPI INSTANT INK UK,4.49,,648.89,Other Shopping,,
350,351,14/04/2022,CPT,LNK SAINSBURYS BAN,40.0,,653.38,Cash,,
351,352,14/04/2022,BP,SAVE THE CHANGE,0.88,,693.38,Savings,Nottingham,Uk
352,353,13/04/2022,DEB,LIDL GB NOTTINGHAM,66.13,,694.26,Groceries,Nottingham,Uk
353,354,13/04/2022,DEB,UBER   *TRIP,4.99,,760.39,Travel,,
354,355,13/04/2022,BP,SAVE THE CHANGE,0.01,,765.38,Savings,Nottingham,Uk
355,356,12/04/2022,DEB,AMZNMktplace,9.99,,765.39,Amazon,Nottingham,Uk
356,357,12/04/2022,BP,SAVE THE CHANGE,0.1,,775.38,Savings,Nottingham,Uk
357,358,11/04/2022,DEB,AMZNMktplace,16.97,,775.48,Amazon,Nottingham,Uk
358,359,11/04/2022,DEB,UBER   *TRIP,6.93,,792.45,Travel,,
359,360,11/04/2022,BP,SAVE THE CHANGE,4.88,,799.38,Savings,Nottingham,Uk
360,361,11/04/2022,DEB,STARBUCKS,13.1,,804.26,Dine Out,,
361,362,11/04/2022,DEB,KELLYS CELLARS,7.8,,817.36,Dine Out,Belfast,Uk
362,363,11/04/2022,DEB,ARRIVA MERSEYSIDE,4.6,,825.16,Travel,,
363,364,11/04/2022,DEB,STARBUCKS,3.75,,829.76,Dine Out,,
364,365,11/04/2022,CPT,LNK TESCO M M WA N,40.0,,833.51,Cash,,
365,366,11/04/2022,DEB,JUMON,56.1,,873.51,Dine Out,Belfast,Uk
366,367,11/04/2022,DEB,UBER   *TRIP,7.07,,929.61,Travel,,
367,368,08/04/2022,DEB,DARCYS RESTAURANT,39.5,,936.68,Dine Out,Belfast,Uk
368,369,08/04/2022,DEB,THE GIANTS BARN CA,5.2,,976.18,Dine Out,Bushmills,Uk
369,370,08/04/2022,BP,SAVE THE CHANGE,1.81,,981.38,Savings,Nottingham,Uk
370,371,07/04/2022,FPO,MISS D WU,40.0,,983.19,Services,Nottingham,Uk
371,372,07/04/2022,DEB,AZZURRI RESTAURANT,24.9,,1023.19,Dine Out,Newcastle upon tyne,Uk
372,373,07/04/2022,DEB,Subway 69392 Belfa,9.98,,1048.09,Dine Out,Belfast,Uk
373,374,07/04/2022,DEB,LIDL NI LTD,7.29,,1058.07,Groceries,Nottingham,Uk
374,375,07/04/2022,DEB,UBER   *TRIP,6.02,,1065.36,Travel,,
375,376,07/04/2022,BP,SAVE THE CHANGE,2.0,,1071.38,Savings,Nottingham,Uk
376,377,06/04/2022,DEB,GetYourGuide UK Lt,43.0,,1073.38,Travel,,
377,378,06/04/2022,DEB,GetYourGuide UK Lt,36.0,,1116.38,Travel,,
378,379,06/04/2022,DEB,LIDL NI LTD,37.09,,1152.38,Groceries,Nottingham,Uk
379,380,06/04/2022,DEB,VISIT BELFAST,23.0,,1189.47,Travel,Belfast,Uk
380,381,06/04/2022,DEB,BURGER KING,18.68,,1212.47,Dine Out,,
381,382,06/04/2022,DEB,LITTLE WING PIZZER,15.8,,1231.15,Dine Out,Belfast,Uk
382,383,06/04/2022,DEB,UBER   *TRIP,6.83,,1246.95,Travel,,
383,384,06/04/2022,DEB,ARRIVA MERSEYSIDE,4.6,,1253.78,Travel,,
384,385,06/04/2022,BP,SAVE THE CHANGE,1.38,,1258.38,Savings,Nottingham,Uk
385,386,05/04/2022,DEB,LIDL GB  NOTTINGHA,16.13,,1259.76,Groceries,Nottingham,Uk
386,387,05/04/2022,DEB,UBER   *TRIP,6.49,,1275.89,Travel,,
387,388,05/04/2022,BP,SAVE THE CHANGE,0.98,,1282.38,Savings,Nottingham,Uk
388,389,04/04/2022,DEP,CLUB LLOYDS WAIVED,,3.0,1283.36,Supplementary Income,Nottingham,Uk
389,390,04/04/2022,PAY,CLUB LLOYDS FEE,3.0,,1280.36,Bills,Nottingham,Uk
390,391,04/04/2022,DEB,ZTL*White Rose Tra,18.0,,1283.36,Clothes,Nottingham,Uk
391,392,04/04/2022,DEB,SLIM CHICKENS NOTT,8.0,,1301.36,Groceries,Nottingham,Uk
392,393,04/04/2022,DEB,HEAVENLY DESSERTS,7.02,,1309.36,Dine Out,Nottingham,Uk
393,394,04/04/2022,CPT,LNK TESCO HK R NOT,40.0,,1316.38,Cash,Nottingham,Uk
394,395,04/04/2022,BP,SAVE THE CHANGE,2.12,,1356.38,Savings,Nottingham,Uk
395,396,04/04/2022,DEB,200 DEGREES,10.2,,1358.5,Dine Out,Nottingham,Uk
396,397,04/04/2022,DEB,THE BREWHOUSE ART,4.0,,1368.7,Others,Nottingham,Uk
397,398,04/04/2022,DEB,EASTMIDLANDSCOM,50.0,,1372.7,Travel,,
398,399,04/04/2022,DEB,LIDL GB  NOTTINGHA,13.34,,1422.7,Groceries,Nottingham,Uk
399,400,04/04/2022,DEB,ATRIUM JUBILEE 1,4.45,,1436.04,Dine Out,Nottingham,Uk
400,401,04/04/2022,FPO,MISS D WU,44.0,,1440.49,Services,Nottingham,Uk
401,402,04/04/2022,TFR,R LAWRENCE  02APR22,,126.0,1484.49,Supplementary Income,Nottingham,Uk
402,403,04/04/2022,FPO,MISS D WU,34.0,,1358.49,Services,Nottingham,Uk
403,404,01/04/2022,,INTEREST (GROSS),,0.49,1392.49,Interest,Nottingham,Uk
404,405,01/04/2022,DEB,Subway 32610 Midla,6.89,,1392.0,Dine Out,Nottingham,Uk
405,406,01/04/2022,FPO,MISS D WU,20.0,,1398.89,Services,Nottingham,Uk
406,407,01/04/2022,DD,BARCLAYS UK MTGES,981.71,,1418.89,Bills,Nottingham,Uk
407,408,01/04/2022,DD,NOTTM CITY COUNC,106.25,,2400.6,Bills,Nottingham,Uk
408,409,01/04/2022,DD,OCTOPUS ENERGY,90.0,,2506.85,Bills,Nottingham,Uk
409,410,01/04/2022,DD,SEVERN TRENT WATER,41.89,,2596.85,Bills,Nottingham,Uk
410,411,01/04/2022,SO,ESAVINGS ACCOUNT,300.0,,2638.74,Savings,Nottingham,Uk
411,412,01/04/2022,BP,SAVE THE CHANGE,1.27,,2938.74,Savings,Nottingham,Uk
412,413,31/03/2022,DEB,DELIVEROO,10.48,,2940.01,Dine Out,,
413,414,31/03/2022,DEB,ATRIUM JUBILEE 1,4.25,,2950.49,Dine Out,Nottingham,Uk
414,415,31/03/2022,FPO,TRADING212UK,1000.0,,2954.74,Investment,Nottingham,Uk
415,416,31/03/2022,BP,SAVE THE CHANGE,1.31,,3954.74,Savings,Nottingham,Uk
416,417,30/03/2022,DEB,STARBUCKS,11.85,,3956.05,Dine Out,,
417,418,30/03/2022,DEB,Subway 32610 Midla,6.19,,3967.9,Dine Out,Nottingham,Uk
418,419,30/03/2022,DEB,ATRIUM JUBILEE 1,2.65,,3974.09,Dine Out,Nottingham,Uk
419,420,30/03/2022,BGC,UNIV OF NOTTINGHAM,,3801.43,3976.74,Paycheck,Nottingham,Uk
420,421,29/03/2022,BP,SAVE THE CHANGE,0.45,,175.31,Savings,Nottingham,Uk
421,422,28/03/2022,DEB,UBER   *TRIP,6.55,,175.76,Travel,,
422,423,28/03/2022,BP,SAVE THE CHANGE,4.38,,182.31,Savings,Nottingham,Uk
423,424,28/03/2022,DEB,LIDL GB NOTTINGHAM,47.83,,186.69,Groceries,Nottingham,Uk
424,425,28/03/2022,DEB,ORIENTAL MART HYDR,20.28,,234.52,Groceries,Nottingham,Uk
425,426,28/03/2022,DEB,POUNDLAND LTD 1726,13.0,,254.8,Groceries,Nottingham,Uk
426,427,28/03/2022,DEB,AMZNMktplace,5.99,,267.8,Amazon,Nottingham,Uk
427,428,28/03/2022,FPO,MISS D WU,20.0,,273.79,Services,Nottingham,Uk
428,429,28/03/2022,FPO,TAMBA TAM,10.0,,293.79,Services,Nottingham,Uk
429,430,28/03/2022,DEB,KFC NOTTINGHAM,1.49,,303.79,Dine Out,Nottingham,Uk
430,431,28/03/2022,DEB,SQ *NOTTINGHAM BAC,12.0,,305.28,Entertainment,Nottingham,Uk
431,432,28/03/2022,DEB,CONFETTI CONSTELLA,7.1,,317.28,Home Improvement,Nottingham,Uk
432,433,28/03/2022,DEB,CONFETTI CONSTELLA,6.2,,324.38,Home Improvement,Nottingham,Uk
433,434,25/03/2022,DEB,AIRBNB * HMREJB2DY,376.55,,330.58,Hotels,,
434,435,25/03/2022,DEB,Subway 32610 Midla,10.18,,707.13,Dine Out,Nottingham,Uk
435,436,25/03/2022,FPO,TRADING212UK,200.0,,717.31,Investment,Nottingham,Uk
436,437,25/03/2022,DD,TALKTALK LIMITED,29.95,,917.31,Bills,Nottingham,Uk
437,438,25/03/2022,BP,SAVE THE CHANGE,0.1,,947.26,Savings,Nottingham,Uk
438,439,24/03/2022,DEB,EASYJET   000K38,327.92,,947.36,Travel,,
439,440,24/03/2022,DEB,AMZNMktplace,9.99,,1275.28,Amazon,Nottingham,Uk
440,441,24/03/2022,DEB,Audible UK,7.99,,1285.27,Entertainment,Nottingham,Uk
441,442,24/03/2022,FPI,PAULINA PIPPEN,,320.0,1293.26,Supplementary Income,Nottingham,Uk
442,443,24/03/2022,BP,SAVE THE CHANGE,0.89,,973.26,Savings,Nottingham,Uk
443,444,23/03/2022,TFR,R LAWRENCE,,300.0,974.15,Supplementary Income,Nottingham,Uk
444,445,23/03/2022,DEB,AMZNMktplace,6.49,,674.15,Amazon,Nottingham,Uk
445,446,23/03/2022,DEB,ATRIUM JUBILEE 1,2.65,,680.64,Dine Out,Nottingham,Uk
446,447,23/03/2022,DEB,LIDL GB NOTTINGHAM,1.97,,683.29,Groceries,Nottingham,Uk
447,448,23/03/2022,BP,SAVE THE CHANGE,0.5,,685.26,Savings,Nottingham,Uk
448,449,23/03/2022,BGC,GOOGLE IRELAND,,63.27,685.76,Supplementary Income,Nottingham,Uk
449,450,22/03/2022,FPO,TRADING212UK,200.0,,622.49,Investment,Nottingham,Uk
450,451,22/03/2022,FPI,SHEILA SMITH,,380.0,822.49,Supplementary Income,Nottingham,Uk
451,452,22/03/2022,CPT,LNK TESCO NO RA RD,40.0,,442.49,Cash,Nottingham,Uk
452,453,22/03/2022,DEB,PRIMARK,13.5,,482.49,Clothes,,
453,454,22/03/2022,BP,SAVE THE CHANGE,1.5,,495.99,Savings,Nottingham,Uk
454,455,21/03/2022,DEB,TESCO STORES 6430,7.55,,497.49,Groceries,,
455,456,21/03/2022,DEB,STARBUCKS,6.45,,505.04,Dine Out,,
456,457,21/03/2022,DEB,SPORTSDIRECT 195,4.5,,511.49,Other Shopping,,
457,458,21/03/2022,BP,SAVE THE CHANGE,2.54,,515.99,Savings,Nottingham,Uk
458,459,21/03/2022,DEB,LIDL GB  NOTTINGHA,28.13,,518.53,Groceries,Nottingham,Uk
459,460,21/03/2022,FPO,MISS D WU,30.0,,546.66,Services,Nottingham,Uk
460,461,18/03/2022,DEB,HPI INSTANT INK UK,4.49,,576.66,Other Shopping,,
461,462,18/03/2022,DEB,SUMUP  *LTP,15.0,,581.15,Services,Nottingham,Uk
462,463,18/03/2022,DEB,Subway 32610 Midla,6.19,,596.15,Dine Out,Nottingham,Uk
463,464,18/03/2022,DEB,ATRIUM JUBILEE 1,2.65,,602.34,Dine Out,Nottingham,Uk
464,465,17/03/2022,DD,VIRGIN MEDIA PYMTS,25.5,,604.99,Bills,Nottingham,Uk
465,466,17/03/2022,BP,SAVE THE CHANGE,1.85,,630.49,Savings,Nottingham,Uk
466,467,16/03/2022,DEB,LIDL GB NOTTINGHAM,16.1,,632.34,Groceries,Nottingham,Uk
467,468,16/03/2022,DEB,ATRIUM JUBILEE 1,13.5,,648.44,Dine Out,Nottingham,Uk
468,469,16/03/2022,DEB,Amazon.co.uk*2159U,5.84,,661.94,Amazon,Nottingham,Uk
469,470,16/03/2022,DEB,UBER   *TRIP,4.71,,667.78,Travel,,
470,471,16/03/2022,FPO,MISS D WU,6.35,,672.49,Services,Nottingham,Uk
471,472,16/03/2022,DD,O2,17.31,,678.84,Other Shopping,Nottingham,Uk
472,473,15/03/2022,BP,SAVE THE CHANGE,2.0,,696.15,Savings,Nottingham,Uk
473,474,14/03/2022,FPO,TAMBA TAM,7.0,,698.15,Services,Nottingham,Uk
474,475,14/03/2022,DEB,LIDL GB NOTTINGHAM,53.54,,705.15,Groceries,Nottingham,Uk
475,476,14/03/2022,DEB,UBER   *TRIP,5.33,,758.69,Travel,,
476,477,14/03/2022,DEB,UBER   *TRIP,19.33,,764.02,Travel,,
477,478,14/03/2022,DEB,UBER   *TRIP,17.8,,783.35,Travel,,
478,479,14/03/2022,BP,SAVE THE CHANGE,2.15,,801.15,Savings,Nottingham,Uk
479,480,14/03/2022,DEB,RAMSDALE PARK GC,13.0,,803.3,Entertainment,Nottingham,Uk
480,481,14/03/2022,DEB,RAMSDALE PARK GC,13.0,,816.3,Entertainment,Nottingham,Uk
481,482,14/03/2022,DEB,Subway 30392 Lento,8.58,,829.3,Dine Out,Nottingham,Uk
482,483,14/03/2022,DEB,RAMSDALE PARK GC,7.85,,837.88,Entertainment,Nottingham,Uk
483,484,14/03/2022,CPT,LNK COOPERATIVE LE,50.0,,845.73,Cash,Leicester,Uk
484,485,14/03/2022,DEB,Subway 26377 Corne,7.28,,895.73,Dine Out,Nottingham,Uk
485,486,11/03/2022,DEB,SUMUP  *LTP,15.0,,903.01,Services,Nottingham,Uk
486,487,11/03/2022,DEB,Subway 32610 Midla,6.89,,918.01,Dine Out,Nottingham,Uk
487,488,11/03/2022,DEB,ATRIUM JUBILEE 1,4.25,,924.9,Dine Out,Nottingham,Uk
488,489,10/03/2022,FPO,TAMBA TAM,10.0,,929.15,Services,Nottingham,Uk
489,490,10/03/2022,BP,SAVE THE CHANGE,0.76,,939.15,Savings,Nottingham,Uk
490,491,09/03/2022,DEB,Amazon Prime*2X250,79.0,,939.91,Amazon,Nottingham,Uk
491,492,09/03/2022,DEB,Amazon.co.uk*2X7YI,13.99,,1018.91,Amazon,Nottingham,Uk
492,493,09/03/2022,DEB,Amazon.co.uk*2X6A1,6.0,,1032.9,Amazon,Nottingham,Uk
493,494,09/03/2022,DEB,ATRIUM JUBILEE 1,4.25,,1038.9,Dine Out,Nottingham,Uk
494,495,09/03/2022,BP,SAVE THE CHANGE,0.26,,1043.15,Savings,Nottingham,Uk
495,496,08/03/2022,DEB,LIDL GB  NOTTINGHA,20.76,,1043.41,Groceries,Nottingham,Uk
496,497,08/03/2022,DEB,AMZNMktplace,14.99,,1064.17,Amazon,Nottingham,Uk
497,498,08/03/2022,DEB,AMZNMktplace,9.99,,1079.16,Amazon,Nottingham,Uk
498,499,08/03/2022,BP,SAVE THE CHANGE,0.12,,1089.15,Savings,Nottingham,Uk
499,500,07/03/2022,DEB,CINEWORLD,32.88,,1089.27,Entertainment,Nottingham,Uk
500,501,07/03/2022,BP,SAVE THE CHANGE,4.52,,1122.15,Savings,Nottingham,Uk
501,502,07/03/2022,DEB,ORIENTAL MART HYDR,54.52,,1126.67,Groceries,Nottingham,Uk
502,503,07/03/2022,DEB,LIDL GB NOTTINGHAM,48.3,,1181.19,Groceries,Nottingham,Uk
503,504,07/03/2022,DEB,Tasnack,25.7,,1229.49,Dine Out,Nottingham,Uk
504,505,07/03/2022,DEB,NOTTINGHAM WATCH R,10.0,,1255.19,Others,Nottingham,Uk
505,506,07/03/2022,DEB,UBER* TRIP,5.16,,1265.19,Travel,,
506,507,07/03/2022,DEB,HEAVENLY DESSERTS,6.2,,1270.35,Dine Out,Nottingham,Uk
507,508,07/03/2022,CPT,LOYD LOYD LOWER PA,40.0,,1276.55,Cash,Nottingham,Uk
508,509,04/03/2022,DEB,SUMUP  *LTP,24.0,,1316.55,Services,Nottingham,Uk
509,510,04/03/2022,DEB,Subway 32610 Midla,6.89,,1340.55,Dine Out,Nottingham,Uk
510,511,04/03/2022,DEB,ATRIUM JUBILEE 1,4.25,,1347.44,Dine Out,Nottingham,Uk
511,512,04/03/2022,DEB,LIDL GB NOTTINGHAM,2.46,,1351.69,Groceries,Nottingham,Uk
512,513,04/03/2022,BP,SAVE THE CHANGE,0.75,,1354.15,Savings,Nottingham,Uk
513,514,03/03/2022,DEB,Amazon.co.uk*2X4DF,7.0,,1354.9,Amazon,Nottingham,Uk
514,515,03/03/2022,DEB,ATRIUM JUBILEE 1,4.25,,1361.9,Dine Out,Nottingham,Uk
515,516,03/03/2022,BP,SAVE THE CHANGE,0.86,,1366.15,Savings,Nottingham,Uk
516,517,02/03/2022,DEP,CLUB LLOYDS WAIVED,,3.0,1367.01,Supplementary Income,Nottingham,Uk
517,518,02/03/2022,PAY,CLUB LLOYDS FEE,3.0,,1364.01,Bills,Nottingham,Uk
518,519,02/03/2022,DEB,TESCO STORES 5653,16.6,,1367.01,Groceries,,
519,520,02/03/2022,DEB,Subway 32610 Midla,6.89,,1383.61,Dine Out,Nottingham,Uk
520,521,02/03/2022,DEB,ATRIUM JUBILEE 1,2.65,,1390.5,Dine Out,Nottingham,Uk
521,522,02/03/2022,TFR,R LAWRENCE,,27.69,1393.15,Supplementary Income,Nottingham,Uk
522,523,02/03/2022,FPO,TAMBA TAM,7.0,,1365.46,Services,Nottingham,Uk
523,524,02/03/2022,FPO,MISS D WU,10.0,,1372.46,Services,Nottingham,Uk
524,525,02/03/2022,BP,SAVE THE CHANGE,0.95,,1382.46,Savings,Nottingham,Uk
525,526,01/03/2022,,INTEREST (GROSS),,0.47,1383.41,Interest,Nottingham,Uk
526,527,01/03/2022,DEB,SAINSBURYS S/MKTS,33.05,,1382.94,Groceries,,
527,528,01/03/2022,DD,BARCLAYS UK MTGES,981.71,,1415.99,Bills,Nottingham,Uk
528,529,01/03/2022,DD,NOTTM CITY COUNC,157.0,,2397.7,Bills,Nottingham,Uk
529,530,01/03/2022,DD,OCTOPUS ENERGY,90.0,,2554.7,Bills,Nottingham,Uk
530,531,01/03/2022,DD,SEVERN TRENT WATER,41.89,,2644.7,Bills,Nottingham,Uk
531,532,01/03/2022,SO,ESAVINGS ACCOUNT,300.0,,2686.59,Savings,Nottingham,Uk
532,533,01/03/2022,BP,SAVE THE CHANGE,1.08,,2986.59,Savings,Nottingham,Uk
533,534,28/02/2022,DEB,UBER   *TRIP,7.11,,2987.67,Travel,,
534,535,28/02/2022,DEB,UBER   *TRIP,6.81,,2994.78,Travel,,
535,536,28/02/2022,BP,SAVE THE CHANGE,2.47,,3001.59,Savings,Nottingham,Uk
536,537,28/02/2022,DEB,BURGER KING,13.57,,3004.06,Dine Out,,
537,538,28/02/2022,DEB,LIDL GB  NOTTINGHA,10.11,,3017.63,Groceries,Nottingham,Uk
538,539,28/02/2022,DEB,SQ *NOTTINGHAM BAC,12.0,,3027.74,Entertainment,Nottingham,Uk
539,540,28/02/2022,DEB,CONFETTI CONSTELLA,8.2,,3039.74,Home Improvement,Nottingham,Uk
540,541,28/02/2022,FPO,MISS D WU,5.1,,3047.94,Services,Nottingham,Uk
541,542,28/02/2022,FPO,MISS D WU,11.0,,3053.04,Services,Nottingham,Uk
542,543,25/02/2022,DEB,SUMUP  *LTP,30.0,,3064.04,Services,Nottingham,Uk
543,544,25/02/2022,DEB,ATRIUM JUBILEE 1,2.65,,3094.04,Dine Out,Nottingham,Uk
544,545,25/02/2022,FPO,TRADING212UK,200.0,,3096.69,Investment,Nottingham,Uk
545,546,25/02/2022,FPO,TRADING212UK,1000.0,,3296.69,Investment,Nottingham,Uk
546,547,25/02/2022,FPI,PAULINA PIPPEN,,317.0,4296.69,Supplementary Income,Nottingham,Uk
547,548,25/02/2022,DD,TALKTALK LIMITED,29.95,,3979.69,Bills,Nottingham,Uk
548,549,25/02/2022,BP,SAVE THE CHANGE,0.01,,4009.64,Savings,Nottingham,Uk
549,550,25/02/2022,BGC,UNIV OF NOTTINGHAM,,3801.83,4009.65,Paycheck,Nottingham,Uk
550,551,24/02/2022,FPO,MISS D WU,10.0,,207.82,Services,Nottingham,Uk
551,552,24/02/2022,DEB,Audible UK,7.99,,217.82,Entertainment,Nottingham,Uk
552,553,24/02/2022,FPO,TAMBA TAM,10.0,,225.81,Services,Nottingham,Uk
553,554,24/02/2022,FPO,MISS D WU,5.6,,235.81,Services,Nottingham,Uk
554,555,24/02/2022,BP,SAVE THE CHANGE,1.15,,241.41,Savings,Nottingham,Uk
555,556,23/02/2022,DEB,UBER   *TRIP,13.31,,242.56,Travel,,
556,557,23/02/2022,DEB,Subway 32610 Midla,10.88,,255.87,Dine Out,Nottingham,Uk
557,558,23/02/2022,DEB,ATRIUM JUBILEE 1,9.75,,266.75,Dine Out,Nottingham,Uk
558,559,23/02/2022,DEB,UBER* TRIP,7.91,,276.5,Travel,,
559,560,23/02/2022,FPO,TRADING212UK,200.0,,284.41,Investment,Nottingham,Uk
560,561,23/02/2022,BP,SAVE THE CHANGE,0.51,,484.41,Savings,Nottingham,Uk
561,562,22/02/2022,DEB,ORIENTAL MART HYDR,17.51,,484.92,Groceries,Nottingham,Uk
562,563,22/02/2022,DEB,T K MAXX,5.98,,502.43,Other Shopping,,
563,564,22/02/2022,BP,SAVE THE CHANGE,1.26,,508.41,Savings,Nottingham,Uk
564,565,21/02/2022,DEB,TESCO STORE 2960,35.54,,509.67,Groceries,,
565,566,21/02/2022,DEB,HEAVENLY DESSERTS,7.2,,545.21,Dine Out,Nottingham,Uk
566,567,21/02/2022,BP,SAVE THE CHANGE,2.11,,552.41,Savings,Nottingham,Uk
567,568,21/02/2022,DEB,AMZNMktplace,9.99,,554.52,Amazon,Nottingham,Uk
568,569,21/02/2022,DEB,SAINSBURY S S/MKTS,1.69,,564.51,Groceries,,
569,570,21/02/2022,FPI,SHEILA SMITH,,380.0,566.2,Supplementary Income,Nottingham,Uk
570,571,21/02/2022,DEB,LIDL GB  NOTTINGHA,19.65,,186.2,Groceries,Nottingham,Uk
571,572,21/02/2022,FPO,MISS D WU,36.5,,205.85,Services,Nottingham,Uk
572,573,21/02/2022,FPO,MISS D WU,10.0,,242.35,Services,Nottingham,Uk
573,574,18/02/2022,DEB,AMZNMktplace,42.43,,252.35,Amazon,Nottingham,Uk
574,575,18/02/2022,DEB,SUMUP  *LTP,15.0,,294.78,Services,Nottingham,Uk
575,576,18/02/2022,DEB,Subway 32610 Midla,6.89,,309.78,Dine Out,Nottingham,Uk
576,577,18/02/2022,DEB,ATRIUM JUBILEE 1,2.65,,316.67,Dine Out,Nottingham,Uk
577,578,18/02/2022,DEB,JUBILEE SPAR,1.59,,319.32,Others,Nottingham,Uk
578,579,18/02/2022,CPT,LNK TESCO HK R NOT,30.0,,320.91,Cash,Nottingham,Uk
579,580,17/02/2022,DD,VIRGIN MEDIA PYMTS,25.5,,350.91,Bills,Nottingham,Uk
580,581,17/02/2022,BP,SAVE THE CHANGE,1.56,,376.41,Savings,Nottingham,Uk
581,582,16/02/2022,DEB,Subway 32610 Midla,6.19,,377.97,Dine Out,Nottingham,Uk
582,583,16/02/2022,DEB,ATRIUM JUBILEE 1,4.25,,384.16,Dine Out,Nottingham,Uk
583,584,16/02/2022,DD,O2,16.66,,388.41,Other Shopping,Nottingham,Uk
584,585,16/02/2022,BP,SAVE THE CHANGE,1.6,,405.07,Savings,Nottingham,Uk
585,586,15/02/2022,DEB,THE CALCUTTA CLUB,93.85,,406.67,Dine Out,Nottingham,Uk
586,587,15/02/2022,DEB,LIDL GB  NOTTINGHA,7.31,,500.52,Groceries,Nottingham,Uk
587,588,15/02/2022,DEB,HPI INSTANT INK UK,3.49,,507.83,Other Shopping,,
588,589,15/02/2022,DEB,HEAVENLY DESSERTS,20.75,,511.32,Dine Out,Nottingham,Uk
589,590,15/02/2022,DEB,THE CALCUTTA CLUB,,9.05,532.07,Supplementary Income,Nottingham,Uk
590,591,15/02/2022,BP,SAVE THE CHANGE,1.73,,523.02,Savings,Nottingham,Uk
591,592,14/02/2022,DEB,CINEWORLD NOT CP,17.98,,524.75,Entertainment,Nottingham,Uk
592,593,14/02/2022,DEB,Subway 26377 Corne,11.68,,542.73,Dine Out,Nottingham,Uk
593,594,14/02/2022,DEB,TESCO STORES 5954,4.05,,554.41,Groceries,,
594,595,14/02/2022,DEB,UBER   *TRIP,5.56,,558.46,Travel,,
595,596,14/02/2022,BP,SAVE THE CHANGE,3.03,,564.02,Savings,Nottingham,Uk
596,597,14/02/2022,DEB,Kiehls since 1851,39.6,,567.05,Other Shopping,,
597,598,14/02/2022,DEB,LIDL GB NOTTINGHAM,35.04,,606.65,Groceries,Nottingham,Uk
598,599,14/02/2022,DEB,LIDL GB NOTTINGHAM,31.26,,641.69,Groceries,Nottingham,Uk
599,600,14/02/2022,DEB,The Body Shop,12.75,,672.95,Other Shopping,,
600,601,14/02/2022,DEB,AMZNMktplace,14.32,,685.7,Amazon,Nottingham,Uk
601,602,14/02/2022,DEB,SUMUP  *HAVANA SAL,10.0,,700.02,Services,Nottingham,Uk
602,603,14/02/2022,FPO,MISS D WU,7.0,,710.02,Services,Nottingham,Uk
603,604,11/02/2022,FPO,MISS D WU,10.0,,717.02,Services,Nottingham,Uk
604,605,11/02/2022,BP,SAVE THE CHANGE,0.94,,727.02,Savings,Nottingham,Uk
605,606,10/02/2022,DEB,LIDL GB  NOTTINGHA,20.06,,727.96,Groceries,Nottingham,Uk
606,607,10/02/2022,BP,SAVE THE CHANGE,0.73,,748.02,Savings,Nottingham,Uk
607,608,09/02/2022,DEB,AMZNMktplace,47.68,,748.75,Amazon,Nottingham,Uk
608,609,09/02/2022,DEB,AMZNMktplace,33.59,,796.43,Amazon,Nottingham,Uk
609,610,09/02/2022,BP,SAVE THE CHANGE,0.35,,830.02,Savings,Nottingham,Uk
610,611,08/02/2022,DEB,PRET A MANGER,30.65,,830.37,Dine Out,,
611,612,08/02/2022,BP,SAVE THE CHANGE,4.02,,861.02,Savings,Nottingham,Uk
612,613,07/02/2022,DEB,EAST MIDS RAILWAY,66.5,,865.04,Travel,,
613,614,07/02/2022,DEB,UBER   *TRIP,18.3,,931.54,Travel,,
614,615,07/02/2022,DEB,GREGGS,10.2,,949.84,Dine Out,,
615,616,07/02/2022,DEB,UBER   *TRIP,8.83,,960.04,Travel,,
616,617,07/02/2022,DEB,UBER   *TRIP,8.47,,968.87,Travel,,
617,618,07/02/2022,DEB,UBER   *TRIP,7.15,,977.34,Travel,,
618,619,07/02/2022,DEB,UBER   *TRIP,6.0,,984.49,Travel,,
619,620,07/02/2022,DEB,UBER   *TRIP,9.71,,990.49,Travel,,
620,621,07/02/2022,DEB,UBER   *TRIP,8.82,,1000.2,Travel,,
621,622,07/02/2022,BP,SAVE THE CHANGE,3.63,,1009.02,Savings,Nottingham,Uk
622,623,07/02/2022,FPO,MISS D WU,59.0,,1012.65,Services,Nottingham,Uk
623,624,07/02/2022,DEB,MUANG THAI 9 LTD,45.95,,1071.65,Dine Out,London,Uk
624,625,07/02/2022,DEB,STARBUCKS,17.64,,1117.6,Dine Out,,
625,626,07/02/2022,DEB,BOOTSKILBURN,4.89,,1135.24,Other Shopping,London,Uk
626,627,07/02/2022,DEB,UBER   *TRIP,11.44,,1140.13,Travel,,
627,628,07/02/2022,DEB,MCDONALDS,10.51,,1151.57,Dine Out,,
628,629,07/02/2022,DEB,UBER   *TRIP,8.93,,1162.08,Travel,,
629,630,07/02/2022,DEB,WELCOME BREAK-NEWP,7.75,,1171.01,Others,Nottingham,Uk
630,631,07/02/2022,DEB,TESCO STORES 5244,7.75,,1178.76,Groceries,,
631,632,07/02/2022,DEB,UBER   *TRIP,7.4,,1186.51,Travel,,
632,633,07/02/2022,DEB,UBER   *TRIP,1.0,,1193.91,Travel,,
633,634,07/02/2022,DEB,LIDL GB  NOTTINGHA,7.86,,1194.91,Groceries,Nottingham,Uk
634,635,04/02/2022,DEB,ATRIUM JUBILEE 1,4.25,,1202.77,Dine Out,Nottingham,Uk
635,636,04/02/2022,DEB,BookingUK (LTD),,30.6,1207.02,Supplementary Income,Nottingham,Uk
636,637,04/02/2022,BP,SAVE THE CHANGE,0.46,,1176.42,Savings,Nottingham,Uk
637,638,03/02/2022,DEB,BookingUK (LTD),187.96,,1176.88,Travel,,
638,639,03/02/2022,DEB,LIDL GB  NOTTINGHA,14.58,,1364.84,Groceries,Nottingham,Uk
639,640,03/02/2022,BP,SAVE THE CHANGE,1.69,,1379.42,Savings,Nottingham,Uk
640,641,02/02/2022,DEP,CLUB LLOYDS WAIVED,,3.0,1381.11,Supplementary Income,Nottingham,Uk
641,642,02/02/2022,PAY,CLUB LLOYDS FEE,3.0,,1378.11,Bills,Nottingham,Uk
642,643,02/02/2022,DEB,Subway 32610 Midla,6.19,,1381.11,Dine Out,Nottingham,Uk
643,644,02/02/2022,DEB,LIDL GB NOTTINGHAM,5.47,,1387.3,Groceries,Nottingham,Uk
644,645,02/02/2022,DEB,ATRIUM JUBILEE 1,2.65,,1392.77,Dine Out,Nottingham,Uk
645,646,02/02/2022,FPO,MISS D WU,7.0,,1395.42,Services,Nottingham,Uk
646,647,02/02/2022,CPT,LNK TESCO HK R NOT,50.0,,1402.42,Cash,Nottingham,Uk
647,648,02/02/2022,FPO,TAMBA TAM,8.0,,1452.42,Services,Nottingham,Uk
648,649,02/02/2022,BP,SAVE THE CHANGE,0.35,,1460.42,Savings,Nottingham,Uk
649,650,01/02/2022,,INTEREST (GROSS),,0.48,1460.77,Interest,Nottingham,Uk
650,651,01/02/2022,DEB,AMZNMktplace,23.85,,1460.29,Amazon,Nottingham,Uk
651,652,01/02/2022,DEB,HEAVENLY DESSERTS,17.8,,1484.14,Dine Out,Nottingham,Uk
652,653,01/02/2022,TFR,R LAWRENCE,,150.0,1501.94,Supplementary Income,Nottingham,Uk
653,654,01/02/2022,DD,BARCLAYS UK MTGES,981.71,,1351.94,Bills,Nottingham,Uk
654,655,01/02/2022,DD,NOTTM CITY COUNC,157.0,,2333.65,Bills,Nottingham,Uk
655,656,01/02/2022,DD,OCTOPUS ENERGY,90.0,,2490.65,Bills,Nottingham,Uk
656,657,01/02/2022,DD,SEVERN TRENT WATER,41.89,,2580.65,Bills,Nottingham,Uk
657,658,01/02/2022,SO,ESAVINGS ACCOUNT,300.0,,2622.54,Savings,Nottingham,Uk
658,659,01/02/2022,BP,SAVE THE CHANGE,0.88,,2922.54,Savings,Nottingham,Uk
659,660,31/01/2022,DEB,UBER   *TRIP,5.12,,2923.42,Travel,,
660,661,31/01/2022,DEB,UBER   *TRIP,1.0,,2928.54,Travel,,
661,662,31/01/2022,BP,SAVE THE CHANGE,2.48,,2929.54,Savings,Nottingham,Uk
662,663,31/01/2022,DEB,LIDL GB NOTTINGHAM,58.54,,2932.02,Groceries,Nottingham,Uk
663,664,31/01/2022,FPO,TAMBA TAM,10.0,,2990.56,Services,Nottingham,Uk
664,665,31/01/2022,FPO,TAMBA TAM,10.0,,3000.56,Services,Nottingham,Uk
665,666,31/01/2022,DEB,CASSAL RESTAURANTS,17.0,,3010.56,Dine Out,,
666,667,31/01/2022,DEB,AMZNMktplace,11.99,,3027.56,Amazon,Nottingham,Uk
667,668,31/01/2022,FPO,MISS D WU,10.0,,3039.55,Services,Nottingham,Uk
668,669,31/01/2022,FPO,MISS D WU,5.0,,3049.55,Services,Nottingham,Uk
669,670,28/01/2022,DEB,SUMUP  *LTP,24.0,,3054.55,Services,Nottingham,Uk
670,671,28/01/2022,DEB,Subway 32610 Midla,6.19,,3078.55,Dine Out,Nottingham,Uk
671,672,28/01/2022,DEB,ATRIUM JUBILEE 1,4.25,,3084.74,Dine Out,Nottingham,Uk
672,673,28/01/2022,DEB,TESCO STORES 5653,0.55,,3088.99,Groceries,,
673,674,28/01/2022,FPO,TRADING212UK,1100.0,,3089.54,Investment,Nottingham,Uk
674,675,28/01/2022,DD,TALKTALK LIMITED,26.42,,4189.54,Bills,Nottingham,Uk
675,676,28/01/2022,BP,SAVE THE CHANGE,0.77,,4215.96,Savings,Nottingham,Uk
676,677,28/01/2022,BGC,UNIV OF NOTTINGHAM,,3801.84,4216.73,Paycheck,Nottingham,Uk
677,678,27/01/2022,DEB,LIDL GB  NOTTINGHA,17.23,,414.89,Groceries,Nottingham,Uk
678,679,27/01/2022,BP,SAVE THE CHANGE,0.92,,432.12,Savings,Nottingham,Uk
679,680,26/01/2022,DEB,Subway 32610 Midla,6.99,,433.04,Dine Out,Nottingham,Uk
680,681,26/01/2022,DEB,ATRIUM JUBILEE 1,2.65,,440.03,Dine Out,Nottingham,Uk
681,682,26/01/2022,DEB,AMZNMktplace,48.44,,442.68,Amazon,Nottingham,Uk
682,683,26/01/2022,FPO,TAMBA TAM,10.0,,491.12,Services,Nottingham,Uk
683,684,26/01/2022,BP,SAVE THE CHANGE,0.83,,501.12,Savings,Nottingham,Uk
684,685,26/01/2022,FPO,MISS D WU,7.0,,501.95,Services,Nottingham,Uk
685,686,25/01/2022,DEB,YE OLDE TRIP TO JE,21.17,,508.95,Dine Out,Nottingham,Uk
686,687,25/01/2022,FPO,TRADING212UK,200.0,,530.12,Investment,Nottingham,Uk
687,688,25/01/2022,FPO,VINOTH VINCE,5.0,,730.12,Services,Nottingham,Uk
688,689,25/01/2022,BP,SAVE THE CHANGE,1.21,,735.12,Savings,Nottingham,Uk
689,690,24/01/2022,FPI,PAULINA PIPPEN,,320.0,736.33,Supplementary Income,Nottingham,Uk
690,691,24/01/2022,DEB,Audible UK,7.99,,416.33,Entertainment,Nottingham,Uk
691,692,24/01/2022,DEB,ROLLS ROYCE LEISUR,4.5,,424.32,Entertainment,Derby,Uk
692,693,24/01/2022,DEB,ROLLS ROYCE LEISUR,4.3,,428.82,Entertainment,Derby,Uk
693,694,24/01/2022,BP,SAVE THE CHANGE,1.46,,433.12,Savings,Nottingham,Uk
694,695,24/01/2022,DEB,MOWGLI STREET FOOD,35.85,,434.58,Dine Out,Nottingham,Uk
695,696,24/01/2022,DEB,NOTTINGHAM CASTLE,19.0,,470.43,Entertainment,Nottingham,Uk
696,697,21/01/2022,DEB,LIDL GB NOTTINGHAM,18.94,,489.43,Groceries,Nottingham,Uk
697,698,21/01/2022,DEB,ATRIUM JUBILEE 1,2.3,,508.37,Dine Out,Nottingham,Uk
698,699,21/01/2022,DEB,CAFFE NERO NOTTING,9.45,,510.67,Dine Out,Nottingham,Uk
699,700,21/01/2022,CPT,LNK TESCO HK R NOT,40.0,,520.12,Cash,Nottingham,Uk
700,701,21/01/2022,BP,SAVE THE CHANGE,0.57,,560.12,Savings,Nottingham,Uk
701,702,20/01/2022,FPO,TRADING212UK,300.0,,560.69,Investment,Nottingham,Uk
702,703,20/01/2022,FPI,SHEILA SMITH,,380.0,860.69,Supplementary Income,Nottingham,Uk
703,704,20/01/2022,DEB,ORIENTAL MART HYDR,9.78,,480.69,Groceries,Nottingham,Uk
704,705,20/01/2022,DEB,GREGGS,2.65,,490.47,Dine Out,,
705,706,20/01/2022,BP,SAVE THE CHANGE,1.31,,493.12,Savings,Nottingham,Uk
706,707,19/01/2022,DEB,Subway 32610 Midla,6.19,,494.43,Dine Out,Nottingham,Uk
707,708,19/01/2022,DEB,ATRIUM JUBILEE 1,2.5,,500.62,Dine Out,Nottingham,Uk
708,709,19/01/2022,BP,SAVE THE CHANGE,0.69,,503.12,Savings,Nottingham,Uk
709,710,18/01/2022,FPO,MISS D WU,6.0,,503.81,Services,Nottingham,Uk
710,711,18/01/2022,FPO,TAMBA TAM,10.0,,509.81,Services,Nottingham,Uk
711,712,18/01/2022,DEB,LIDL GB  NOTTINGHA,17.31,,519.81,Groceries,Nottingham,Uk
712,713,18/01/2022,BP,SAVE THE CHANGE,0.1,,537.12,Savings,Nottingham,Uk
713,714,17/01/2022,DEB,CAVES,19.9,,537.22,Entertainment,Nottingham,Uk
714,715,17/01/2022,DD,VIRGIN MEDIA PYMTS,25.5,,557.12,Bills,Nottingham,Uk
715,716,17/01/2022,DD,O2,17.06,,582.62,Other Shopping,Nottingham,Uk
716,717,17/01/2022,BP,SAVE THE CHANGE,3.42,,599.68,Savings,Nottingham,Uk
717,718,17/01/2022,DEB,MUSEUM,16.4,,603.1,Entertainment,,
718,719,17/01/2022,DEB,200 DEGREES,9.7,,619.5,Dine Out,Nottingham,Uk
719,720,17/01/2022,DEB,POUNDLAND LTD 1718,8.75,,629.2,Groceries,Nottingham,Uk
720,721,17/01/2022,FPO,TAMBA TAM,115.0,,637.95,Services,Nottingham,Uk
721,722,17/01/2022,DEB,LIDL GB  NOTTINGHA,20.45,,752.95,Groceries,Nottingham,Uk
722,723,14/01/2022,DEB,Subway 32610 Midla,6.19,,773.4,Dine Out,Nottingham,Uk
723,724,14/01/2022,DEB,ORIENTAL MART HYDR,5.1,,779.59,Groceries,Nottingham,Uk
724,725,14/01/2022,DEB,AMZNMktplace,12.99,,784.69,Amazon,Nottingham,Uk
725,726,14/01/2022,BP,SAVE THE CHANGE,0.51,,797.68,Savings,Nottingham,Uk
726,727,14/01/2022,FPO,ANTIGONI ABRAHMS,6.0,,798.19,Entertainment,London,Uk
727,728,13/01/2022,DEB,HPI INSTANT INK UK,3.49,,804.19,Other Shopping,,
728,729,13/01/2022,BP,SAVE THE CHANGE,1.16,,807.68,Savings,Nottingham,Uk
729,730,12/01/2022,DEB,TESCO STORE 2960,12.2,,808.84,Groceries,,
730,731,12/01/2022,DEB,Subway 32610 Midla,6.99,,821.04,Dine Out,Nottingham,Uk
731,732,12/01/2022,DEB,ATRIUM JUBILEE 1,2.65,,828.03,Dine Out,Nottingham,Uk
732,733,12/01/2022,BP,SAVE THE CHANGE,0.21,,830.68,Savings,Nottingham,Uk
733,734,11/01/2022,DEB,RAJAH FOOD STORE L,38.79,,830.89,Groceries,Nottingham,Uk
734,735,11/01/2022,BP,SAVE THE CHANGE,0.52,,869.68,Savings,Nottingham,Uk
735,736,10/01/2022,DEB,YANKEE STORE,19.48,,870.2,Other Shopping,,
736,737,10/01/2022,BP,SAVE THE CHANGE,2.99,,889.68,Savings,Nottingham,Uk
737,738,10/01/2022,DEB,DISCO BOWL NOTTING,20.5,,892.67,Entertainment,Nottingham,Uk
738,739,10/01/2022,DEB,FUNSTATION,15.0,,913.17,Entertainment,Nottingham,Uk
739,740,10/01/2022,DEB,MCDONALDS,13.87,,928.17,Dine Out,,
740,741,10/01/2022,DEB,POUNDLAND LTD 1718,13.0,,942.04,Groceries,Nottingham,Uk
741,742,10/01/2022,DEB,POUNDLAND LTD 1726,7.5,,955.04,Groceries,Nottingham,Uk
742,743,10/01/2022,DEB,LIDL GB NOTTINGHAM,5.67,,962.54,Groceries,Nottingham,Uk
743,744,10/01/2022,DEB,UBER   *TRIP,5.12,,968.21,Travel,,
744,745,10/01/2022,DEB,UBER   *TRIP,1.0,,973.33,Travel,,
745,746,10/01/2022,DEB,AMZ*Zeina Foods,,14.5,974.33,Supplementary Income,Nottingham,Uk
746,747,07/01/2022,DEB,TESCO STORE 2960,18.35,,959.83,Groceries,,
747,748,07/01/2022,BP,SAVE THE CHANGE,3.67,,978.18,Savings,Nottingham,Uk
748,749,06/01/2022,FPO,MISS D WU,1.0,,981.85,Services,Nottingham,Uk
749,750,06/01/2022,DEB,LIDL GB  NOTTINGHA,12.54,,982.85,Groceries,Nottingham,Uk
750,751,06/01/2022,DEB,Subway 39497 Victo,6.19,,995.39,Dine Out,Nottingham,Uk
751,752,06/01/2022,DEB,TESCO STORE 2960,1.15,,1001.58,Groceries,,
752,753,06/01/2022,DEB,AMZNMktplace,51.05,,1002.73,Amazon,Nottingham,Uk
753,754,06/01/2022,DEB,Amazon.co.uk*PU3OT,6.4,,1053.78,Amazon,Nottingham,Uk
754,755,06/01/2022,BP,SAVE THE CHANGE,0.09,,1060.18,Savings,Nottingham,Uk
755,756,05/01/2022,DEP,CLUB LLOYDS WAIVED,,3.0,1060.27,Supplementary Income,Nottingham,Uk
756,757,05/01/2022,PAY,CLUB LLOYDS FEE,3.0,,1057.27,Bills,Nottingham,Uk
757,758,05/01/2022,DEB,UBER   *TRIP,5.91,,1060.27,Travel,,
758,759,05/01/2022,DEB,NEW STREET HCO,39.0,,1066.18,Clothes,,
759,760,05/01/2022,BP,SAVE THE CHANGE,1.51,,1105.18,Savings,Nottingham,Uk
760,761,04/01/2022,,INTEREST (GROSS),,1.09,1106.69,Interest,Swansea,Uk
761,762,04/01/2022,FPO,ROBERT RECORD,14.0,,1105.6,Others,Nottingham,Uk
762,763,04/01/2022,DEB,BIRMINGHAM NS TVM,42.6,,1119.6,Hotels,Birmingham,Uk
763,764,04/01/2022,DEB,WAGAMAMA BIRMINGHA,24.85,,1162.2,Dine Out,Birmingham,Uk
764,765,04/01/2022,DEB,H & M,17.99,,1187.05,Clothes,,
765,766,04/01/2022,DEB,Caffe Concerto,15.05,,1205.04,Dine Out,London/birmingham,Uk
766,767,04/01/2022,DEB,UBER   *TRIP,1.0,,1220.09,Travel,,
767,768,04/01/2022,FPO,TRADING212UK,700.0,,1221.09,Investment,Nottingham,Uk
768,769,04/01/2022,DD,BARCLAYS UK MTGES,981.71,,1921.09,Bills,Nottingham,Uk
769,770,04/01/2022,DD,NOTTM CITY COUNC,157.0,,2902.8,Bills,Nottingham,Uk
770,771,04/01/2022,DD,OCTOPUS ENERGY,90.0,,3059.8,Bills,Nottingham,Uk
771,772,04/01/2022,DD,SEVERN TRENT WATER,41.89,,3149.8,Bills,Nottingham,Uk
772,773,04/01/2022,BP,Q WANG,,782.0,3191.69,Supplementary Income,Nottingham,Uk
773,774,04/01/2022,SO,ESAVINGS ACCOUNT,300.0,,2409.69,Savings,Nottingham,Uk
774,775,04/01/2022,BP,SAVE THE CHANGE,3.17,,2709.69,Savings,Nottingham,Uk
775,776,04/01/2022,DEB,HOLIDAY INN EXPRES,65.0,,2712.86,Hotels,,
776,777,04/01/2022,DEB,LAS IGUANAS - TEMP,37.4,,2777.86,Dine Out,Nottingham,Uk
777,778,04/01/2022,DEB,UBER   *TRIP,24.08,,2815.26,Travel,,
778,779,04/01/2022,DEB,AMZNMktplace,9.99,,2839.34,Amazon,Nottingham,Uk
779,780,04/01/2022,DEB,HILTON HOTELS,1.0,,2849.33,Hotels,,
780,781,04/01/2022,DEB,AMZNMktplace,190.87,,2850.33,Amazon,Nottingham,Uk
781,782,04/01/2022,DEB,HILTON HOTELS,235.0,,3041.2,Hotels,,
782,783,04/01/2022,DEB,VIETNAMESE STREET,31.46,,3276.2,Dine Out,Birmingham,Uk
783,784,31/12/2021,DEB,LIDL GB  NOTTINGHA,11.58,,3307.66,Groceries,Nottingham,Uk
784,785,31/12/2021,DEB,AMZNMktplace,13.45,,3319.24,Amazon,Nottingham,Uk
785,786,31/12/2021,DD,TALKTALK LIMITED,21.0,,3332.69,Bills,Nottingham,Uk
786,787,30/12/2021,BP,SAVE THE CHANGE,0.75,,3353.69,Savings,Nottingham,Uk
787,788,29/12/2021,DEB,LIDL GB  NOTTINGHA,17.28,,3354.44,Groceries,Nottingham,Uk
788,789,29/12/2021,DEB,AMZNMktplace,5.97,,3371.72,Amazon,Nottingham,Uk
789,790,29/12/2021,BP,SAVE THE CHANGE,1.25,,3377.69,Savings,Nottingham,Uk
790,791,29/12/2021,DEB,WILKO RETAIL LIMIT,13.0,,3378.94,Other Shopping,,
791,792,29/12/2021,DEB,UBER   *TRIP,12.42,,3391.94,Travel,Nottingham,Uk
792,793,29/12/2021,DEB,UBER   *TRIP,1.0,,3404.36,Travel,Nottingham,Uk
793,794,29/12/2021,FPO,TAMBA TAM,85.0,,3405.36,Services,Nottingham,Uk
794,795,29/12/2021,DEB,AMZNMktplace,15.9,,3490.36,Amazon,Nottingham,Uk
795,796,29/12/2021,DEB,AMZNMktplace,9.99,,3506.26,Amazon,Nottingham,Uk
796,797,29/12/2021,FPO,TRADING212UK,200.0,,3516.25,Investment,Nottingham,Uk
797,798,29/12/2021,CPT,LNK 583 MANSFIELD,100.0,,3716.25,Cash,Mansfiled,Uk
798,799,29/12/2021,DEB,GOOGLE *YouTube Vi,3.49,,3816.25,,Nottingham,Uk
799,800,29/12/2021,FPI,PAULINA PIPPEN,,320.0,3819.74,Supplementary Income,Nottingham,Uk
800,801,24/12/2021,DEB,CINEWORLD NOT CP,31.97,,3499.74,Entertainment,Nottingham,Uk
801,802,24/12/2021,DEB,AMZNMktplace,12.99,,3531.71,Amazon,Nottingham,Uk
802,803,24/12/2021,DEB,Audible UK,7.99,,3544.7,Entertainment,Nottingham,Uk
803,804,24/12/2021,BP,SAVE THE CHANGE,2.19,,3552.69,Savings,Nottingham,Uk
804,805,23/12/2021,DEB,EAST MIDS RAILWAY,8.4,,3554.88,Travel,Nottingham,Uk
805,806,23/12/2021,DEB,Subway 39497 Victo,6.19,,3563.28,Dine Out,Nottingham,Uk
806,807,23/12/2021,DEB,AMZNMktplace,14.95,,3569.47,Amazon,Nottingham,Uk
807,808,23/12/2021,DEB,AMZNMktplace,11.27,,3584.42,Amazon,Nottingham,Uk
808,809,23/12/2021,BP,SAVE THE CHANGE,0.24,,3595.69,Savings,Nottingham,Uk
809,810,22/12/2021,DEB,LIDL GB  NOTTINGHA,10.76,,3595.93,Groceries,Nottingham,Uk
810,811,22/12/2021,FPO,TRADING212UK,1000.0,,3606.69,Investment,Nottingham,Uk
811,812,22/12/2021,BP,SAVE THE CHANGE,0.6,,4606.69,Savings,Nottingham,Uk
812,813,22/12/2021,BGC,UNIV OF NOTTINGHAM,,3801.43,4607.29,Paycheck,Nottingham,Uk
813,814,21/12/2021,DEB,LIDL GB  NOTTINGHA,27.61,,805.86,Groceries,Nottingham,Uk
814,815,21/12/2021,DEB,HOLLAND & BARRETT,15.98,,833.47,Groceries,,
815,816,21/12/2021,DEB,T K MAXX,11.97,,849.45,Other Shopping,,
816,817,21/12/2021,DEB,ORIENTAL MART HYDR,8.85,,861.42,Groceries,Nottingham,Uk
817,818,21/12/2021,DEB,AMZNMktplace,13.99,,870.27,Amazon,Nottingham,Uk
818,819,21/12/2021,FPO,TRADING212UK,100.0,,884.26,Investment,Nottingham,Uk
819,820,21/12/2021,FPO,TRADING212UK,700.0,,984.26,Investment,Nottingham,Uk
820,821,21/12/2021,FPI,Q WANG,,1000.0,1684.26,Supplementary Income,Nottingham,Uk
821,822,21/12/2021,BP,SAVE THE CHANGE,0.6,,684.26,Savings,Nottingham,Uk
822,823,20/12/2021,FPO,TRADING212UK,300.0,,684.86,Investment,Nottingham,Uk
823,824,20/12/2021,FPI,SHEILA SMITH,,380.0,984.86,Supplementary Income,Nottingham,Uk
824,825,20/12/2021,DEB,SAINSBURYS S/MKTS,34.4,,604.86,Groceries,,
825,826,20/12/2021,BP,SAVE THE CHANGE,1.08,,639.26,Savings,Nottingham,Uk
826,827,20/12/2021,DEB,AMZNMktplace,5.99,,640.34,Amazon,Nottingham,Uk
827,828,17/12/2021,DEB,BIRMINGHAM NS T/O,17.0,,646.33,Hotels,Birmingham,Uk
828,829,17/12/2021,DEB,ATRIUM JUBILEE 1,4.25,,663.33,Dine Out,Nottingham,Uk
829,830,17/12/2021,DEB,AMZNMktplace,31.99,,667.58,Amazon,Nottingham,Uk
830,831,17/12/2021,DEB,Amazon.co.uk*8J9B3,6.69,,699.57,Amazon,Nottingham,Uk
831,832,17/12/2021,DEB,ANTIGONI ABRAHMS,6.0,,706.26,Entertainment,London,Uk
832,833,17/12/2021,TFR,R LAWRENCE,,300.0,712.26,Supplementary Income,Nottingham,Uk
833,834,17/12/2021,FPO,MR J LITCHFIELD,340.0,,412.26,Services,Nottingham,Uk
834,835,17/12/2021,DD,VIRGIN MEDIA PYMTS,25.5,,752.26,Bills,Nottingham,Uk
835,836,17/12/2021,BP,SAVE THE CHANGE,3.0,,777.76,Savings,Nottingham,Uk
836,837,16/12/2021,DEB,COMFORT INN BIRMIN,53.1,,780.76,Hotels,Birmingham,Uk
837,838,16/12/2021,DEB,NANDOS BULLRING,39.1,,833.86,Dine Out,Birmingham,Uk
838,839,16/12/2021,DEB,EAST MIDS RAILWAY,27.5,,872.96,Travel,Nottingham,Uk
839,840,16/12/2021,DEB,WAGAMAMA BIRMINGHA,16.8,,900.46,Dine Out,Birmingham,Uk
840,841,16/12/2021,DEB,DANTER ATTRACTIONS,7.0,,917.26,Entertainment,Birmingham,Uk
841,842,16/12/2021,DEB,DANTER ATTRACTIONS,7.0,,924.26,Entertainment,Birmingham,Uk
842,843,16/12/2021,DEB,IZ *EPICURIOSITY L,5.5,,931.26,Groceries,,
843,844,16/12/2021,DEB,STARBUCKS,4.0,,936.76,Dine Out,,
844,845,16/12/2021,DD,O2,16.66,,940.76,Other Shopping,Nottingham,Uk
845,846,16/12/2021,BP,SAVE THE CHANGE,0.82,,957.42,Savings,Nottingham,Uk
846,847,15/12/2021,DEB,Subway 32610 Midla,6.19,,958.24,Dine Out,Nottingham,Uk
847,848,15/12/2021,DEB,AMZNMKTPLACE AMAZO,11.99,,964.43,Amazon,Nottingham,Uk
848,849,15/12/2021,CPT,LOYD LOYD 36 - 38,40.0,,976.42,Cash,Birmingham,Uk
849,850,15/12/2021,BP,SAVE THE CHANGE,1.4,,1016.42,Savings,Nottingham,Uk
850,851,14/12/2021,FPO,TAMBA TAM,10.0,,1017.82,Services,Nottingham,Uk
851,852,14/12/2021,DEB,LIDL GB  NOTTINGHA,25.12,,1027.82,Groceries,Nottingham,Uk
852,853,14/12/2021,DEB,AMZNMktplace,12.99,,1052.94,Amazon,Nottingham,Uk
853,854,14/12/2021,DEB,HPI INSTANT INK UK,3.49,,1065.93,Other Shopping,,
854,855,14/12/2021,BP,SAVE THE CHANGE,0.5,,1069.42,Savings,Nottingham,Uk
855,856,13/12/2021,DEB,Audible UK,18.0,,1069.92,Entertainment,Nottingham,Uk
856,857,13/12/2021,DEB,SUMUP  *CODE 34,22.5,,1087.92,Services,Nottingham,Uk
857,858,13/12/2021,BP,SAVE THE CHANGE,2.78,,1110.42,Savings,Nottingham,Uk
858,859,13/12/2021,DEB,LAND ROVER SOCIAL,5.55,,1113.2,Entertainment,Solihull,Uk
859,860,13/12/2021,DEB,THE BLIND RABBIT,9.25,,1118.75,Dine Out,Nottingham,Uk
860,861,13/12/2021,DEB,THE BLIND RABBIT,7.95,,1128.0,Dine Out,Nottingham,Uk
861,862,13/12/2021,FPO,TAMBA TAM,15.0,,1135.95,Services,Nottingham,Uk
862,863,13/12/2021,DEB,No. Twelve,45.63,,1150.95,Dine Out,Nottingham,Uk
863,864,13/12/2021,DEB,ATRIUM JUBILEE 1,2.65,,1196.58,Dine Out,Nottingham,Uk
864,865,10/12/2021,DEP,CLUB LLOYDS WAIVED,,3.0,1199.23,Supplementary Income,Nottingham,Uk
865,866,10/12/2021,PAY,CLUB LLOYDS FEE,3.0,,1196.23,Bills,Nottingham,Uk
866,867,10/12/2021,DEB,Subway 32610 Midla,6.19,,1199.23,Dine Out,Nottingham,Uk
867,868,10/12/2021,DEB,ANTIGONI ABRAHMS,6.0,,1205.42,Entertainment,London,Uk
868,869,09/12/2021,BP,SAVE THE CHANGE,0.42,,1211.42,Savings,Nottingham,Uk
869,870,08/12/2021,DEB,AMZNMktplace,9.99,,1211.84,Amazon,Nottingham,Uk
870,871,08/12/2021,DEB,AMZNMktplace,8.59,,1221.83,Amazon,Nottingham,Uk
871,872,08/12/2021,BP,SAVE THE CHANGE,0.8,,1230.42,Savings,Nottingham,Uk
872,873,07/12/2021,FPO,TAMBA TAM,10.0,,1231.22,Services,Nottingham,Uk
873,874,07/12/2021,FPO,TAMBA TAM,95.0,,1241.22,Services,Nottingham,Uk
874,875,07/12/2021,DEB,LIDL GB  NOTTINGHA,17.2,,1336.22,Groceries,Nottingham,Uk
875,876,07/12/2021,BP,SAVE THE CHANGE,0.63,,1353.42,Savings,Nottingham,Uk
876,877,06/12/2021,DEB,ORIENTAL MART HYDR,27.97,,1354.05,Groceries,Nottingham,Uk
877,878,06/12/2021,DEB,TESCO STORES 6735,3.4,,1382.02,Groceries,,
878,879,06/12/2021,BP,SAVE THE CHANGE,1.56,,1385.42,Savings,Nottingham,Uk
879,880,06/12/2021,CPT,LNK TESCO LONG ROW,40.0,,1386.98,Cash,Nottingham,Uk
880,881,06/12/2021,DEB,SUMUP  *TODO LATIN,10.0,,1426.98,Entertainment,Nottingham,Uk
881,882,06/12/2021,DEB,ATRIUM JUBILEE 1,4.25,,1436.98,Dine Out,Nottingham,Uk
882,883,03/12/2021,FPO,ANDREW MUMBI,24.0,,1441.23,Services,Nottingham,Uk
883,884,03/12/2021,DEB,Subway 32610 Midla,6.19,,1465.23,Dine Out,Nottingham,Uk
884,885,03/12/2021,BP,SAVE THE CHANGE,0.15,,1471.42,Savings,Nottingham,Uk
885,886,02/12/2021,DEB,ANTIGONI ABRAHMS,6.0,,1471.57,Entertainment,London,Uk
886,887,02/12/2021,DEB,LIDL GB  NOTTINGHA,10.85,,1477.57,Groceries,Nottingham,Uk
887,888,02/12/2021,BP,SAVE THE CHANGE,0.82,,1488.42,Savings,Nottingham,Uk
888,889,01/12/2021,,INTEREST (GROSS),,0.68,1489.24,Interest,Nottingham,Uk
889,890,01/12/2021,FPO,VINOTH VINCE,10.0,,1488.56,Services,Nottingham,Uk
890,891,01/12/2021,DEB,Amazon.co.uk*072AV,12.99,,1498.56,Amazon,Nottingham,Uk
891,892,01/12/2021,DEB,Subway 32610 Midla,6.19,,1511.55,Dine Out,Nottingham,Uk
892,893,01/12/2021,TFR,R LAWRENCE,,191.99,1517.74,Supplementary Income,Nottingham,Uk
893,894,01/12/2021,DD,BARCLAYS UK MTGES,981.71,,1325.75,Bills,Nottingham,Uk
894,895,01/12/2021,DD,NOTTM CITY COUNC,157.0,,2307.46,Bills,Nottingham,Uk
895,896,01/12/2021,DD,OCTOPUS ENERGY,90.0,,2464.46,Bills,Nottingham,Uk
896,897,01/12/2021,DD,SEVERN TRENT WATER,41.86,,2554.46,Bills,Nottingham,Uk
897,898,01/12/2021,SO,ESAVINGS ACCOUNT,300.0,,2596.32,Savings,Nottingham,Uk
898,899,01/12/2021,BP,SAVE THE CHANGE,0.34,,2896.32,Savings,Nottingham,Uk
899,900,30/11/2021,FPO,TAMBA TAM,10.0,,2896.66,Services,Nottingham,Uk
900,901,30/11/2021,DEB,RAJAH FOOD STORE L,7.66,,2906.66,Groceries,Nottingham,Uk
901,902,30/11/2021,BP,SAVE THE CHANGE,1.19,,2914.32,Savings,Nottingham,Uk
902,903,29/11/2021,DEB,REVOLUTION DE CUBA,8.75,,2915.51,Dine Out,Nottingham,Uk
903,904,29/11/2021,DEB,REVOLUTION DE CUBA,8.75,,2924.26,Dine Out,Nottingham,Uk
904,905,29/11/2021,DEB,UBER   *EATS,35.31,,2933.01,Dine Out,,
905,906,29/11/2021,FPO,TRADING212UK,1500.0,,2968.32,Investment,Nottingham,Uk
906,907,29/11/2021,BP,SAVE THE CHANGE,1.95,,4468.32,Savings,Nottingham,Uk
907,908,29/11/2021,BGC,UNIV OF NOTTINGHAM,,3801.83,4470.27,Paycheck,Nottingham,Uk
908,909,29/11/2021,FPO,ANDREW MUMBI,15.0,,668.44,Services,Nottingham,Uk
909,910,29/11/2021,DEB,LIDL GB  NOTTINGHA,19.39,,683.44,Groceries,Nottingham,Uk
910,911,29/11/2021,DEB,LIDL GB  NOTTINGHA,18.99,,702.83,Groceries,Nottingham,Uk
911,912,29/11/2021,DEB,AMZNMktplace,6.49,,721.82,Amazon,Nottingham,Uk
912,913,26/11/2021,DEB,AMZNMktplace,9.99,,728.31,Amazon,Nottingham,Uk
913,914,26/11/2021,DEB,Subway 32610 Midla,6.19,,738.3,Dine Out,Nottingham,Uk
914,915,26/11/2021,FPO,TRADING212UK,400.0,,744.49,Investment,Nottingham,Uk
915,916,26/11/2021,FPI,P PROKURAT,,320.0,1144.49,Supplementary Income,Nottingham,Uk
916,917,26/11/2021,DD,TALKTALK LIMITED,21.0,,824.49,Bills,Nottingham,Uk
917,918,25/11/2021,DEB,ANTIGONI ABRAHMS,6.0,,845.49,Entertainment,London,Uk
918,919,25/11/2021,BP,SAVE THE CHANGE,0.82,,851.49,Savings,Nottingham,Uk
919,920,24/11/2021,FPO,TAMBA TAM,10.0,,852.31,Services,Nottingham,Uk
920,921,24/11/2021,FPO,MARIA DONNARUMMA,75.0,,862.31,Services,Nottingham,Uk
921,922,24/11/2021,DEB,Audible UK,7.99,,937.31,Entertainment,Nottingham,Uk
922,923,24/11/2021,DEB,Subway 32610 Midla,6.19,,945.3,Dine Out,Nottingham,Uk
923,924,24/11/2021,BP,SAVE THE CHANGE,0.94,,951.49,Savings,Nottingham,Uk
924,925,24/11/2021,BGC,GOOGLE IRELAND,,63.7,952.43,Supplementary Income,Nottingham,Uk
925,926,23/11/2021,DEB,LIDL GB  NOTTINGHA,17.19,,888.73,Groceries,Nottingham,Uk
926,927,23/11/2021,DEB,RAJAH FOOD STORE L,11.87,,905.92,Groceries,Nottingham,Uk
927,928,23/11/2021,BP,SAVE THE CHANGE,0.13,,917.79,Savings,Nottingham,Uk
928,929,22/11/2021,DEB,AMZNMktplace,17.87,,917.92,Amazon,Nottingham,Uk
929,930,22/11/2021,BP,SAVE THE CHANGE,5.4,,935.79,Savings,Nottingham,Uk
930,931,22/11/2021,DEB,LIDL GB  NOTTINGHA,23.44,,941.19,Groceries,Nottingham,Uk
931,932,22/11/2021,DEB,ORIENTAL MART HYDR,13.11,,964.63,Groceries,Nottingham,Uk
932,933,22/11/2021,DEB,AMZNMktplace,10.99,,977.74,Amazon,Nottingham,Uk
933,934,22/11/2021,DEB,WILKO RETAIL LIMIT,7.75,,988.73,Other Shopping,,
934,935,22/11/2021,DEB,200 DEGREES,5.9,,996.48,Dine Out,Nottingham,Uk
935,936,22/11/2021,DEB,HOLLAND & BARRETT,4.35,,1002.38,Groceries,,
936,937,22/11/2021,FPO,TAMBA TAM,10.0,,1006.73,Services,Nottingham,Uk
937,938,22/11/2021,DEB,Subway 32610 Midla,6.19,,1016.73,Dine Out,Nottingham,Uk
938,939,22/11/2021,DEB,STARBUCKS,6.1,,1022.92,Dine Out,,
939,940,22/11/2021,FPI,SHEILA SMITH,,380.0,1029.02,Supplementary Income,Nottingham,Uk
940,941,19/11/2021,DEB,LIDL GB  NOTTINGHA,12.52,,649.02,Groceries,Nottingham,Uk
941,942,19/11/2021,DEB,ATRIUM JUBILEE 1,4.25,,661.54,Dine Out,Nottingham,Uk
942,943,19/11/2021,FPO,TRADING212UK,400.0,,665.79,Investment,Nottingham,Uk
943,944,19/11/2021,BP,SAVE THE CHANGE,0.51,,1065.79,Savings,Nottingham,Uk
944,945,18/11/2021,DEB,HPI INSTANT INK UK,3.49,,1066.3,Other Shopping,,
945,946,18/11/2021,BP,SAVE THE CHANGE,1.72,,1069.79,Savings,Nottingham,Uk
946,947,17/11/2021,DEB,AMZNMktplace,25.44,,1071.51,Amazon,Nottingham,Uk
947,948,17/11/2021,DEB,Subway 32610 Midla,6.19,,1096.95,Dine Out,Nottingham,Uk
948,949,17/11/2021,DEB,ATRIUM JUBILEE 1,2.65,,1103.14,Dine Out,Nottingham,Uk
949,950,17/11/2021,DD,VIRGIN MEDIA PYMTS,25.5,,1105.79,Bills,Nottingham,Uk
950,951,17/11/2021,BP,SAVE THE CHANGE,1.0,,1131.29,Savings,Nottingham,Uk
951,952,16/11/2021,FPO,TAMBA TAM,10.0,,1132.29,Services,Nottingham,Uk
952,953,16/11/2021,DEB,LIDL GB  NOTTINGHA,23.9,,1142.29,Groceries,Nottingham,Uk
953,954,16/11/2021,DEB,Amazon.co.uk*Y39VW,8.1,,1166.19,Amazon,Nottingham,Uk
954,955,16/11/2021,DD,O2,16.66,,1174.29,Other Shopping,Nottingham,Uk
955,956,15/11/2021,DEB,BLEND COFFEE HOUSE,3.0,,1190.95,Dine Out,Nottingham,Uk
956,957,15/11/2021,DEB,SUMUP  *LOS TRAVIE,70.0,,1193.95,Services,Nottingham,Uk
957,958,15/11/2021,BP,SAVE THE CHANGE,2.59,,1263.95,Savings,Nottingham,Uk
958,959,15/11/2021,DEB,JURYS INN EAST MID,12.55,,1266.54,Hotels,Derby,Uk
959,960,15/11/2021,DEB,ATRIUM JUBILEE 1,4.25,,1279.09,Dine Out,Nottingham,Uk
960,961,15/11/2021,DEB,AMZNMktplace,2.77,,1283.34,Amazon,Nottingham,Uk
961,962,12/11/2021,DEB,Subway 32610 Midla,6.19,,1286.11,Dine Out,Nottingham,Uk
962,963,12/11/2021,DEB,ANTIGONI ABRAHMS,6.0,,1292.3,Entertainment,London,Uk
963,964,12/11/2021,DEB,ATRIUM JUBILEE 1,2.65,,1298.3,Dine Out,Nottingham,Uk
964,965,12/11/2021,BP,SAVE THE CHANGE,0.76,,1300.95,Savings,Nottingham,Uk
965,966,11/11/2021,DEB,LIDL GB  NOTTINGHA,20.24,,1301.71,Groceries,Nottingham,Uk
966,967,11/11/2021,FPO,TRADING212UK,400.0,,1321.95,Investment,Nottingham,Uk
967,968,11/11/2021,BP,SAVE THE CHANGE,1.16,,1721.95,Savings,Nottingham,Uk
968,969,10/11/2021,DEB,Subway 32610 Midla,6.19,,1723.11,Dine Out,Nottingham,Uk
969,970,10/11/2021,DEB,ATRIUM JUBILEE 1,2.65,,1729.3,Dine Out,Nottingham,Uk
970,971,10/11/2021,FPO,L CATATE,20.0,,1731.95,,Nottingham,Uk
971,972,10/11/2021,FPO,TAMBA TAM,10.0,,1751.95,Services,Nottingham,Uk
972,973,09/11/2021,BP,SAVE THE CHANGE,0.35,,1761.95,Savings,Nottingham,Uk
973,974,08/11/2021,DEB,LIDL GB  NOTTINGHA,18.9,,1762.3,Groceries,Nottingham,Uk
974,975,08/11/2021,DEB,REVOLUTION DE CUBA,8.75,,1781.2,Dine Out,Nottingham,Uk
975,976,08/11/2021,BP,SAVE THE CHANGE,2.82,,1789.95,Savings,Nottingham,Uk
976,977,08/11/2021,DEB,ORIENTAL MART HYDR,5.49,,1792.77,Groceries,Nottingham,Uk
977,978,08/11/2021,DEB,ATRIUM JUBILEE 1,4.25,,1798.26,Dine Out,Nottingham,Uk
978,979,05/11/2021,DEB,Subway 32610 Midla,6.19,,1802.51,Dine Out,Nottingham,Uk
979,980,05/11/2021,DEB,ATRIUM JUBILEE 1,4.25,,1808.7,Dine Out,Nottingham,Uk
980,981,05/11/2021,BP,SAVE THE CHANGE,0.08,,1812.95,Savings,Nottingham,Uk
981,982,04/11/2021,DEB,LIDL GB  NOTTINGHA,9.92,,1813.03,Groceries,Nottingham,Uk
982,983,04/11/2021,BP,SAVE THE CHANGE,1.16,,1822.95,Savings,Nottingham,Uk
983,984,03/11/2021,DEB,Subway 32610 Midla,6.19,,1824.11,Dine Out,Nottingham,Uk
984,985,03/11/2021,DEB,ATRIUM JUBILEE 1,2.65,,1830.3,Dine Out,Nottingham,Uk
985,986,03/11/2021,FPO,TAMBA TAM,10.0,,1832.95,Services,Nottingham,Uk
986,987,03/11/2021,BP,SAVE THE CHANGE,1.23,,1842.95,Savings,Nottingham,Uk
987,988,02/11/2021,DEP,CLUB LLOYDS WAIVED,,3.0,1844.18,Supplementary Income,Nottingham,Uk
988,989,02/11/2021,PAY,CLUB LLOYDS FEE,3.0,,1841.18,Bills,Nottingham,Uk
989,990,02/11/2021,DEB,LIDL GB  NOTTINGHA,5.12,,1844.18,Groceries,Nottingham,Uk
990,991,02/11/2021,DEB,ATRIUM JUBILEE 1,2.65,,1849.3,Dine Out,Nottingham,Uk
991,992,02/11/2021,FPO,TRADING212UK,500.0,,1851.95,Investment,Nottingham,Uk
992,993,01/11/2021,,INTEREST (GROSS),,0.78,2351.95,Interest,Nottingham,Uk
993,994,01/11/2021,FPI,Q WANG,,1000.0,2351.17,Supplementary Income,Nottingham,Uk
994,995,01/11/2021,DD,BARCLAYS UK MTGES,981.71,,1351.17,Bills,Nottingham,Uk
995,996,01/11/2021,DD,NOTTM CITY COUNC,157.0,,2332.88,Bills,Nottingham,Uk
996,997,01/11/2021,DD,OCTOPUS ENERGY,90.0,,2489.88,Bills,Nottingham,Uk
997,998,01/11/2021,DD,SEVERN TRENT WATER,35.32,,2579.88,Bills,Nottingham,Uk
998,999,01/11/2021,SO,ESAVINGS ACCOUNT,300.0,,2615.2,Savings,Nottingham,Uk
999,1000,01/11/2021,BP,SAVE THE CHANGE,1.76,,2915.2,Savings,Nottingham,Uk
1000,1001,01/11/2021,DEB,LIDL GB  NOTTINGHA,10.8,,2916.96,Groceries,Nottingham,Uk
1001,1002,01/11/2021,DEB,STARBUCKS,5.6,,2927.76,Dine Out,,
1002,1003,29/10/2021,DEB,Subway 32610 Midla,6.19,,2933.36,Dine Out,Nottingham,Uk
1003,1004,29/10/2021,DEB,FALAFEL,6.0,,2939.55,Dine Out,Nottingham,Uk
1004,1005,29/10/2021,DEB,FALAFEL,3.0,,2945.55,Dine Out,Nottingham,Uk
1005,1006,29/10/2021,DEB,ATRIUM JUBILEE 1,2.65,,2948.55,Dine Out,Nottingham,Uk
1006,1007,29/10/2021,FPO,TRADING212UK,1200.0,,2951.2,Investment,Nottingham,Uk
1007,1008,29/10/2021,DD,TALKTALK LIMITED,21.0,,4151.2,Bills,Nottingham,Uk
1008,1009,29/10/2021,BP,SAVE THE CHANGE,0.43,,4172.2,Savings,Nottingham,Uk
1009,1010,28/10/2021,DEB,ANTIGONI ABRAHMS,6.0,,4172.63,Entertainment,London,Uk
1010,1011,28/10/2021,DEB,LIDL GB  NOTTINGHA,13.57,,4178.63,Groceries,Nottingham,Uk
1011,1012,28/10/2021,BP,SAVE THE CHANGE,1.16,,4192.2,Savings,Nottingham,Uk
1012,1013,28/10/2021,BGC,UNIV OF NOTTINGHAM,,3801.44,4193.36,Paycheck,Nottingham,Uk
1013,1014,27/10/2021,FPO,TAMBA TAM,10.0,,391.92,Services,Nottingham,Uk
1014,1015,27/10/2021,DEB,Subway 32610 Midla,6.19,,401.92,Dine Out,Nottingham,Uk
1015,1016,27/10/2021,DEB,ATRIUM JUBILEE 1,1.65,,408.11,Dine Out,Nottingham,Uk
1016,1017,26/10/2021,FPO,TRADING212UK,350.0,,409.76,Investment,Nottingham,Uk
1017,1018,26/10/2021,BP,SAVE THE CHANGE,0.54,,759.76,Savings,Nottingham,Uk
1018,1019,25/10/2021,DEB,REVOLUTION DE CUBA,9.75,,760.3,Dine Out,Nottingham,Uk
1019,1020,25/10/2021,DEB,CARTWHEEL COFFEE L,6.71,,770.05,Dine Out,Nottingham,Uk
1020,1021,25/10/2021,BP,SAVE THE CHANGE,2.81,,776.76,Savings,Nottingham,Uk
1021,1022,25/10/2021,DEB,PRICKLY PEAR,91.5,,779.57,Dine Out,Nottingham,Uk
1022,1023,25/10/2021,DEB,ORIENTAL MART HYDR,8.33,,871.07,Groceries,Nottingham,Uk
1023,1024,25/10/2021,DEB,Audible UK,7.99,,879.4,Entertainment,Nottingham,Uk
1024,1025,25/10/2021,DEB,LIDL GB  NOTTINGHA,21.18,,887.39,Groceries,Nottingham,Uk
1025,1026,22/10/2021,DEB,Subway 32610 Midla,6.19,,908.57,Dine Out,Nottingham,Uk
1026,1027,22/10/2021,FPI,PAULINA PIPPEN,,320.0,914.76,Supplementary Income,Nottingham,Uk
1027,1028,22/10/2021,FPO,TRADING212UK,400.0,,594.76,Investment,Nottingham,Uk
1028,1029,22/10/2021,BP,SAVE THE CHANGE,0.97,,994.76,Savings,Nottingham,Uk
1029,1030,21/10/2021,FPO,ANTIGONI ABRAHMS,6.0,,995.73,Entertainment,London,Uk
1030,1031,21/10/2021,DEB,SAINSBURYS S/MKTS,29.3,,1001.73,Groceries,,
1031,1032,21/10/2021,DEB,AMZNMktplace,25.73,,1031.03,Amazon,Nottingham,Uk
1032,1033,21/10/2021,BP,SAVE THE CHANGE,0.81,,1056.76,Savings,Nottingham,Uk
1033,1034,20/10/2021,FPI,SHEILA SMITH,,380.0,1057.57,Supplementary Income,Nottingham,Uk
1034,1035,20/10/2021,DEB,Subway 32610 Midla,6.19,,677.57,Dine Out,Nottingham,Uk
1035,1036,20/10/2021,FPO,TAMBA TAM,10.0,,683.76,Services,Nottingham,Uk
1036,1037,20/10/2021,BP,SAVE THE CHANGE,0.71,,693.76,Savings,Nottingham,Uk
1037,1038,19/10/2021,DEB,SP * HOMEDETAIL-UK,239.0,,694.47,Home Improvement,Nottingham,Uk
1038,1039,19/10/2021,DEB,NON-GBP PURCH FEE,0.5,,933.47,Others,Nottingham,Uk
1039,1040,19/10/2021,DEB,NON-GBP TRANS FEE,0.54,,933.97,Others,Nottingham,Uk
1040,1041,19/10/2021,DEB,EB 2021 IEEE CONFE,18.29,,934.51,Travel,Nottingham,Uk
1041,1042,19/10/2021,CPT,LNK NOTTINGHAM UNI,40.0,,952.8,Cash,Nottingham,Uk
1042,1043,19/10/2021,FPO,TRADING212UK,200.0,,992.8,Investment,Nottingham,Uk
1043,1044,19/10/2021,BP,SAVE THE CHANGE,1.42,,1192.8,Savings,Nottingham,Uk
1044,1045,18/10/2021,DEB,AMZNMktplace,15.49,,1194.22,Amazon,Nottingham,Uk
1045,1046,18/10/2021,DEB,AMZNMktplace,9.99,,1209.71,Amazon,Nottingham,Uk
1046,1047,18/10/2021,DEB,REVOLUTION DE CUBA,8.75,,1219.7,Dine Out,Nottingham,Uk
1047,1048,18/10/2021,DEB,CAFFE NERO NOTTING,3.35,,1228.45,Dine Out,Nottingham,Uk
1048,1049,18/10/2021,DEB,GREGGS PLC,2.0,,1231.8,Dine Out,,
1049,1050,18/10/2021,DD,VIRGIN MEDIA PYMTS,25.5,,1233.8,Bills,Nottingham,Uk
1050,1051,18/10/2021,DD,O2,16.66,,1259.3,Other Shopping,Nottingham,Uk
1051,1052,18/10/2021,BP,SAVE THE CHANGE,3.19,,1275.96,Savings,Nottingham,Uk
1052,1053,18/10/2021,DEB,LIDL GB  NOTTINGHA,8.87,,1279.15,Groceries,Nottingham,Uk
1053,1054,18/10/2021,DEB,ATRIUM JUBILEE 1,2.65,,1288.02,Dine Out,Nottingham,Uk
1054,1055,15/10/2021,DEB,Subway 32610 Midla,6.19,,1290.67,Dine Out,Nottingham,Uk
1055,1056,15/10/2021,DEB,SOUTHBANK BAR,5.6,,1296.86,Dine Out,Nottingham,Uk
1056,1057,15/10/2021,DEB,ATRIUM JUBILEE 1,4.25,,1302.46,Dine Out,Nottingham,Uk
1057,1058,15/10/2021,DEB,TESCO STORES 6735,2.25,,1306.71,Groceries,,
1058,1059,15/10/2021,BP,SAVE THE CHANGE,0.51,,1308.96,Savings,Nottingham,Uk
1059,1060,14/10/2021,FPO,ANTIGONI ABRAHMS,6.0,,1309.47,Entertainment,London,Uk
1060,1061,14/10/2021,DEB,HPI INSTANT INK UK,3.49,,1315.47,Other Shopping,,
1061,1062,14/10/2021,BP,SAVE THE CHANGE,1.77,,1318.96,Savings,Nottingham,Uk
1062,1063,13/10/2021,DEB,AMZNMktplace,35.04,,1320.73,Amazon,Nottingham,Uk
1063,1064,13/10/2021,DEB,Subway 32610 Midla,6.19,,1355.77,Dine Out,Nottingham,Uk
1064,1065,13/10/2021,TFR,R LAWRENCE,,400.0,1361.96,Supplementary Income,Nottingham,Uk
1065,1066,13/10/2021,FPO,MR J LITCHFIELD,481.0,,961.96,Services,Nottingham,Uk
1066,1067,13/10/2021,BP,SAVE THE CHANGE,0.03,,1442.96,Savings,Nottingham,Uk
1067,1068,12/10/2021,FPO,TAMBA TAM,10.0,,1442.99,Services,Nottingham,Uk
1068,1069,12/10/2021,DEB,LIDL GB  NOTTINGHA,5.97,,1452.99,Groceries,Nottingham,Uk
1069,1070,12/10/2021,BP,SAVE THE CHANGE,0.25,,1458.96,Savings,Nottingham,Uk
1070,1071,11/10/2021,DEB,REVOLUTION DE CUBA,8.75,,1459.21,Dine Out,Nottingham,Uk
1071,1072,11/10/2021,BP,SAVE THE CHANGE,2.99,,1467.96,Savings,Nottingham,Uk
1072,1073,11/10/2021,DEB,ORIENTAL MART HYDR,5.84,,1470.95,Groceries,Nottingham,Uk
1073,1074,11/10/2021,DEB,SUPERDRUG STORES P,3.9,,1476.79,Other Shopping,,
1074,1075,11/10/2021,DEB,HARTLEYS SANDWICH,2.95,,1480.69,Dine Out,Leeds,Uk
1075,1076,11/10/2021,DEB,PRICKLY PEAR,12.5,,1483.64,Dine Out,Nottingham,Uk
1076,1077,11/10/2021,DEB,LIDL GB  NOTTINGHA,7.69,,1496.14,Groceries,Nottingham,Uk
1077,1078,08/10/2021,DEB,Amazon.co.uk*8T0UU,1.19,,1503.83,Amazon,Nottingham,Uk
1078,1079,08/10/2021,DEB,31K,12.0,,1505.02,Dine Out,Nottingham,Uk
1079,1080,08/10/2021,DEB,STARBUCKS,7.4,,1517.02,Dine Out,,
1080,1081,08/10/2021,DEB,Subway 32610 Midla,6.89,,1524.42,Dine Out,Nottingham,Uk
1081,1082,08/10/2021,DEB,ATRIUM JUBILEE 1,2.65,,1531.31,Dine Out,Nottingham,Uk
1082,1083,08/10/2021,BP,SAVE THE CHANGE,2.3,,1533.96,Savings,Nottingham,Uk
1083,1084,07/10/2021,FPO,ANTIGONI ABRAHMS,6.0,,1536.26,Entertainment,London,Uk
1084,1085,07/10/2021,DEB,AMZNMktplace,19.99,,1542.26,Amazon,Nottingham,Uk
1085,1086,07/10/2021,DEB,LIDL GB  NOTTINGHA,11.11,,1562.25,Groceries,Nottingham,Uk
1086,1087,07/10/2021,DEB,AMZNMktplace,6.5,,1573.36,Amazon,Nottingham,Uk
1087,1088,07/10/2021,DEB,AMZNMktplace,5.1,,1579.86,Amazon,Nottingham,Uk
1088,1089,07/10/2021,BP,SAVE THE CHANGE,0.81,,1584.96,Savings,Nottingham,Uk
1089,1090,06/10/2021,DEB,Subway 32610 Midla,6.19,,1585.77,Dine Out,Nottingham,Uk
1090,1091,06/10/2021,BP,SAVE THE CHANGE,0.36,,1591.96,Savings,Nottingham,Uk
1091,1092,05/10/2021,DEB,AMZNMktplace,23.99,,1592.32,Amazon,Nottingham,Uk
1092,1093,05/10/2021,DEB,LIDL GB  NOTTINGHA,12.65,,1616.31,Groceries,Nottingham,Uk
1093,1094,05/10/2021,BP,SAVE THE CHANGE,1.72,,1628.96,Savings,Nottingham,Uk
1094,1095,04/10/2021,DEP,CLUB LLOYDS WAIVED,,3.0,1630.68,Supplementary Income,Nottingham,Uk
1095,1096,04/10/2021,PAY,CLUB LLOYDS FEE,3.0,,1627.68,Bills,Nottingham,Uk
1096,1097,04/10/2021,DEB,The Speciality Cof,22.2,,1630.68,Dine Out,Nottingham,Uk
1097,1098,04/10/2021,DEB,ORIENTAL MART HYDR,12.08,,1652.88,Groceries,Nottingham,Uk
1098,1099,04/10/2021,BP,SAVE THE CHANGE,2.02,,1664.96,Savings,Nottingham,Uk
1099,1100,04/10/2021,DEB,AMZNMktplace,22.84,,1666.98,Amazon,Nottingham,Uk
1100,1101,04/10/2021,DEB,SUMUP  *TODO LATIN,12.5,,1689.82,Entertainment,Nottingham,Uk
1101,1102,04/10/2021,DEB,U CANTEEN,10.5,,1702.32,Dine Out,Nottingham,Uk
1102,1103,04/10/2021,FPO,TRADING212UK,500.0,,1712.82,Investment,Nottingham,Uk
1103,1104,01/10/2021,,INTEREST (GROSS),,0.79,2212.82,Interest,Nottingham,Uk
1104,1105,01/10/2021,DEB,EB *SPEED DATING O,22.15,,2212.03,Entertainment,Nottingham,Uk
1105,1106,01/10/2021,DEB,AMZNMktplace,8.99,,2234.18,Amazon,Nottingham,Uk
1106,1107,01/10/2021,FPO,ABAYOMI ADAMS,370.0,,2243.17,Safety Deposit Return,Nottingham,Uk
1107,1108,01/10/2021,DD,BARCLAYS UK MTGES,981.71,,2613.17,Bills,Nottingham,Uk
1108,1109,01/10/2021,DD,NOTTM CITY COUNC,157.0,,3594.88,Bills,Nottingham,Uk
1109,1110,01/10/2021,DD,OCTOPUS ENERGY,90.0,,3751.88,Bills,Nottingham,Uk
1110,1111,01/10/2021,DD,SEVERN TRENT WATER,35.32,,3841.88,Bills,Nottingham,Uk
1111,1112,01/10/2021,SO,Q WANG,,1000.0,3877.2,Supplementary Income,Nottingham,Uk
1112,1113,01/10/2021,SO,ESAVINGS ACCOUNT,300.0,,2877.2,Savings,Nottingham,Uk
1113,1114,01/10/2021,BP,SAVE THE CHANGE,0.15,,3177.2,Savings,Nottingham,Uk
1114,1115,30/09/2021,FPO,ANTIGONI ABRAHMS,6.0,,3177.35,Entertainment,London,Uk
1115,1116,30/09/2021,DEB,AMZNMktplace,95.99,,3183.35,Amazon,Nottingham,Uk
1116,1117,30/09/2021,DEB,LIDL GB  NOTTINGHA,16.86,,3279.34,Groceries,Nottingham,Uk
1117,1118,30/09/2021,BP,SAVE THE CHANGE,0.81,,3296.2,Savings,Nottingham,Uk
1118,1119,29/09/2021,DEB,Subway 32610 Midla,6.19,,3297.01,Dine Out,Nottingham,Uk
1119,1120,29/09/2021,FPO,TRADING212UK,1500.0,,3303.2,Investment,Nottingham,Uk
1120,1121,29/09/2021,FPO,TAMBA TAM,10.0,,4803.2,Services,Nottingham,Uk
1121,1122,29/09/2021,BP,SAVE THE CHANGE,0.23,,4813.2,Savings,Nottingham,Uk
1122,1123,29/09/2021,BGC,UNIV OF NOTTINGHAM,,4091.83,4813.43,Paycheck,Nottingham,Uk
1123,1124,28/09/2021,DEB,AMZNMktplace,47.77,,721.6,Amazon,Nottingham,Uk
1124,1125,28/09/2021,BP,SAVE THE CHANGE,1.28,,769.37,Savings,Nottingham,Uk
1125,1126,27/09/2021,DEB,Amazon.co.uk*CM96E,22.27,,770.65,Amazon,Nottingham,Uk
1126,1127,27/09/2021,DEB,REVOLUTION DE CUBA,5.45,,792.92,Dine Out,Nottingham,Uk
1127,1128,27/09/2021,DEB,CAFFE NERO NOTTING,10.0,,798.37,Dine Out,Nottingham,Uk
1128,1129,27/09/2021,DD,TALKTALK LIMITED,21.0,,808.37,Bills,Nottingham,Uk
1129,1130,27/09/2021,BP,SAVE THE CHANGE,3.22,,829.37,Savings,Nottingham,Uk
1130,1131,27/09/2021,DEB,IKEA LTD SHOP ONLI,110.0,,832.59,Other Shopping,,
1131,1132,27/09/2021,DEB,AMZNMktplace,18.99,,942.59,Amazon,Nottingham,Uk
1132,1133,27/09/2021,DEB,ORIENTAL MART HYDR,13.04,,961.58,Groceries,Nottingham,Uk
1133,1134,27/09/2021,DEB,IZ *BELLAPAELLA,7.0,,974.62,Dine Out,Nottingham,Uk
1134,1135,27/09/2021,DEB,LIDL GB  NOTTINGHA,6.32,,981.62,Groceries,Nottingham,Uk
1135,1136,27/09/2021,DEB,LIDL GB  NOTTINGHA,4.57,,987.94,Groceries,Nottingham,Uk
1136,1137,27/09/2021,DEB,AMZNMktplace,3.82,,992.51,Amazon,Nottingham,Uk
1137,1138,27/09/2021,FPO,TRADING212UK,400.0,,996.33,Investment,Nottingham,Uk
1138,1139,27/09/2021,FPI,PAULINA PIPPEN,,320.0,1396.33,Supplementary Income,Nottingham,Uk
1139,1140,24/09/2021,DEB,LIDL GB  NOTTINGHA,9.86,,1076.33,Groceries,Nottingham,Uk
1140,1141,24/09/2021,DEB,Audible UK,7.99,,1086.19,Entertainment,Nottingham,Uk
1141,1142,24/09/2021,DEB,Subway 32610 Midla,6.19,,1094.18,Dine Out,Nottingham,Uk
1142,1143,22/09/2021,BP,SAVE THE CHANGE,1.65,,1100.37,Savings,Nottingham,Uk
1143,1144,21/09/2021,FPO,TAMBA TAM,10.0,,1102.02,Services,Nottingham,Uk
1144,1145,21/09/2021,DEB,LIDL GB  NOTTINGHA,7.16,,1112.02,Groceries,Nottingham,Uk
1145,1146,21/09/2021,DEB,Subway 32610 Midla,6.19,,1119.18,Dine Out,Nottingham,Uk
1146,1147,21/09/2021,FPO,TRADING212UK,400.0,,1125.37,Investment,Nottingham,Uk
1147,1148,21/09/2021,BP,SAVE THE CHANGE,0.6,,1525.37,Savings,Nottingham,Uk
1148,1149,20/09/2021,FPI,SHEILA SMITH,,380.0,1525.97,Supplementary Income,Nottingham,Uk
1149,1150,20/09/2021,DEB,ESCOBAR,21.4,,1145.97,Dine Out,Nottingham,Uk
1150,1151,20/09/2021,BP,SAVE THE CHANGE,1.11,,1167.37,Savings,Nottingham,Uk
1151,1152,20/09/2021,DEB,AMZNMktplace,6.99,,1168.48,Amazon,Nottingham,Uk
1152,1153,20/09/2021,DEB,ORIENTAL MART HYDR,6.94,,1175.47,Groceries,Nottingham,Uk
1153,1154,20/09/2021,DEB,TESCO STORE 2960,3.1,,1182.41,Groceries,,
1154,1155,20/09/2021,DEB,T K MAXX,2.99,,1185.51,Other Shopping,,
1155,1156,20/09/2021,FPO,TRADING212UK,400.0,,1188.5,Investment,Nottingham,Uk
1156,1157,20/09/2021,DEB,AMZNMktplace,9.99,,1588.5,Amazon,Nottingham,Uk
1157,1158,17/09/2021,DEB,Subway 32610 Midla,6.89,,1598.49,Dine Out,Nottingham,Uk
1158,1159,17/09/2021,DEB,Subway 32610 Midla,3.99,,1605.38,Dine Out,Nottingham,Uk
1159,1160,17/09/2021,DD,VIRGIN MEDIA PYMTS,25.5,,1609.37,Bills,Nottingham,Uk
1160,1161,17/09/2021,BP,SAVE THE CHANGE,1.13,,1634.87,Savings,Nottingham,Uk
1161,1162,16/09/2021,FPO,ANTIGONI ABRAHMS,6.0,,1636.0,Entertainment,London,Uk
1162,1163,16/09/2021,DEB,AMZNMktplace,11.99,,1642.0,Amazon,Nottingham,Uk
1163,1164,16/09/2021,DEB,LIDL GB  NOTTINGHA,9.49,,1653.99,Groceries,Nottingham,Uk
1164,1165,16/09/2021,DEB,AMZNMKTPLACE AMAZO,6.39,,1663.48,Amazon,Nottingham,Uk
1165,1166,16/09/2021,DD,O2,16.66,,1669.87,Other Shopping,Nottingham,Uk
1166,1167,16/09/2021,BP,SAVE THE CHANGE,0.81,,1686.53,Savings,Nottingham,Uk
1167,1168,15/09/2021,DEB,Subway 32610 Midla,6.19,,1687.34,Dine Out,Nottingham,Uk
1168,1169,15/09/2021,BP,SAVE THE CHANGE,0.56,,1693.53,Savings,Nottingham,Uk
1169,1170,14/09/2021,FPO,TAMBA TAM,10.0,,1694.09,Services,Nottingham,Uk
1170,1171,14/09/2021,DEB,HPI INSTANT INK UK,3.49,,1704.09,Other Shopping,,
1171,1172,14/09/2021,DEB,AMZNMktplace,14.99,,1707.58,Amazon,Nottingham,Uk
1172,1173,14/09/2021,DEB,LIDL GB  NOTTINGHA,7.96,,1722.57,Groceries,Nottingham,Uk
1173,1174,14/09/2021,BP,SAVE THE CHANGE,1.2,,1730.53,Savings,Nottingham,Uk
1174,1175,13/09/2021,DEB,AMZNMKTPLACE AMAZO,15.9,,1731.73,Amazon,Nottingham,Uk
1175,1176,13/09/2021,DEB,CAFE CHHINO,7.95,,1747.63,Dine Out,Nottingham,Uk
1176,1177,13/09/2021,DEB,REVOLUTION DE CUBA,5.5,,1755.58,Dine Out,Nottingham,Uk
1177,1178,13/09/2021,DEB,REVOLUTION DE CUBA,5.45,,1761.08,Dine Out,Nottingham,Uk
1178,1179,13/09/2021,BP,SAVE THE CHANGE,1.38,,1766.53,Savings,Nottingham,Uk
1179,1180,13/09/2021,DEB,ORIENTAL MART HYDR,6.75,,1767.91,Groceries,Nottingham,Uk
1180,1181,13/09/2021,DEB,LIDL GB  NOTTINGHA,8.3,,1774.66,Groceries,Nottingham,Uk
1181,1182,10/09/2021,DEB,LIDL GB  NOTTINGHA,14.68,,1782.96,Groceries,Nottingham,Uk
1182,1183,10/09/2021,DEB,Subway 32610 Midla,6.89,,1797.64,Dine Out,Nottingham,Uk
1183,1184,10/09/2021,BP,SAVE THE CHANGE,0.12,,1804.53,Savings,Nottingham,Uk
1184,1185,09/09/2021,DEB,AMZNMktplace,10.99,,1804.65,Amazon,Nottingham,Uk
1185,1186,09/09/2021,DEB,IKEA LTD SHOP ONLI,55.0,,1815.64,Other Shopping,,
1186,1187,09/09/2021,DEB,AMZNMktplace,14.89,,1870.64,Amazon,Nottingham,Uk
1187,1188,09/09/2021,FPI,PAULINA PIPPEN,,320.0,1885.53,Supplementary Income,Nottingham,Uk
1188,1189,09/09/2021,BP,SAVE THE CHANGE,0.02,,1565.53,Savings,Nottingham,Uk
1189,1190,08/09/2021,DEB,Subway 32610 Midla,5.99,,1565.55,Dine Out,Nottingham,Uk
1190,1191,08/09/2021,DEB,AMZNMktplace,3.99,,1571.54,Amazon,Nottingham,Uk
1191,1192,08/09/2021,TFR,R LAWRENCE,,500.0,1575.53,Supplementary Income,Nottingham,Uk
1192,1193,08/09/2021,FPO,MR J LITCHFIELD,544.84,,1075.53,Services,Nottingham,Uk
1193,1194,08/09/2021,FPO,TAMBA TAM,10.0,,1620.37,Services,Nottingham,Uk
1194,1195,08/09/2021,BP,SAVE THE CHANGE,0.46,,1630.37,Savings,Nottingham,Uk
1195,1196,07/09/2021,DEB,LIDL GB  NOTTINGHA,9.54,,1630.83,Groceries,Nottingham,Uk
1196,1197,07/09/2021,BP,SAVE THE CHANGE,0.65,,1640.37,Savings,Nottingham,Uk
1197,1198,06/09/2021,DEB,SUMUP  *TODO LATIN,15.0,,1641.02,Entertainment,Nottingham,Uk
1198,1199,06/09/2021,DEB,REVOLUTION DE CUBA,5.35,,1656.02,Dine Out,Nottingham,Uk
1199,1200,06/09/2021,DD,PURE GYM LTD,19.99,,1661.37,Fitness,Nottingham,Uk
1200,1201,06/09/2021,BP,SAVE THE CHANGE,2.8,,1681.36,Savings,Nottingham,Uk
1201,1202,06/09/2021,DEB,ORIENTAL MART HYDR,6.99,,1684.16,Groceries,Nottingham,Uk
1202,1203,06/09/2021,DEB,Amazon.co.uk*RJ1R7,32.21,,1691.15,Amazon,Nottingham,Uk
1203,1204,06/09/2021,DEB,LIDL GB  NOTTINGHA,7.96,,1723.36,Groceries,Nottingham,Uk
1204,1205,03/09/2021,DEB,No. Twelve,66.53,,1731.32,Dine Out,Nottingham,Uk
1205,1206,03/09/2021,DEB,LIDL GB NOTTINGHAM,9.02,,1797.85,Groceries,Nottingham,Uk
1206,1207,03/09/2021,DEB,Subway 32610 Midla,6.49,,1806.87,Dine Out,Nottingham,Uk
1207,1208,03/09/2021,BP,SAVE THE CHANGE,0.46,,1813.36,Savings,Nottingham,Uk
1208,1209,02/09/2021,DEP,CLUB LLOYDS WAIVED,,3.0,1813.82,Supplementary Income,Nottingham,Uk
1209,1210,02/09/2021,FPO,ANTIGONI ABRAHMS,6.0,,1810.82,Entertainment,London,Uk
1210,1211,02/09/2021,PAY,CLUB LLOYDS FEE,3.0,,1816.82,Bills,Nottingham,Uk
1211,1212,02/09/2021,DEB,SUMUP  *TODO LATIN,15.0,,1819.82,Entertainment,Nottingham,Uk
1212,1213,02/09/2021,DEB,AMZNMktplace,8.99,,1834.82,Amazon,Nottingham,Uk
1213,1214,02/09/2021,DEB,REVOLUTION DE CUBA,4.55,,1843.81,Dine Out,Nottingham,Uk
1214,1215,02/09/2021,BP,SAVE THE CHANGE,0.15,,1848.36,Savings,Nottingham,Uk
1215,1216,01/09/2021,,INTEREST (GROSS),,0.87,1848.51,Interest,Nottingham,Uk
1216,1217,01/09/2021,CPT,LNK TESCO HK R NOT,30.0,,1847.64,Cash,Nottingham,Uk
1217,1218,01/09/2021,DEB,SHARIF AND SONS SU,23.88,,1877.64,Groceries,Derby,Uk
1218,1219,01/09/2021,DEB,Amazon.co.uk*XS1VA,11.97,,1901.52,Amazon,Nottingham,Uk
1219,1220,01/09/2021,FPO,TRADING212UK,500.0,,1913.49,Investment,Nottingham,Uk
1220,1221,01/09/2021,FPO,TRADING212UK,100.0,,2413.49,Investment,Nottingham,Uk
1221,1222,01/09/2021,TFR,R LAWRENCE,,200.0,2513.49,Supplementary Income,Nottingham,Uk
1222,1223,01/09/2021,DD,BARCLAYS UK MTGES,981.71,,2313.49,Bills,Nottingham,Uk
1223,1224,01/09/2021,DD,NOTTM CITY COUNC,157.0,,3295.2,Bills,Nottingham,Uk
1224,1225,01/09/2021,DD,OCTOPUS ENERGY,90.0,,3452.2,Bills,Nottingham,Uk
1225,1226,01/09/2021,DD,SEVERN TRENT WATER,35.32,,3542.2,Bills,Nottingham,Uk
1226,1227,01/09/2021,SO,Q WANG,,1000.0,3577.52,Supplementary Income,Nottingham,Uk
1227,1228,01/09/2021,SO,ESAVINGS ACCOUNT,300.0,,2577.52,Savings,Nottingham,Uk
1228,1229,31/08/2021,BP,SAVE THE CHANGE,1.4,,2877.52,Savings,Nottingham,Uk
1229,1230,31/08/2021,DEB,SAINSBURYS S/MKTS,34.18,,2878.92,Groceries,,
1230,1231,31/08/2021,DEB,ANATOLIA TURKISH R,12.0,,2913.1,Dine Out,Nottingham,Uk
1231,1232,31/08/2021,DEB,LIDL GB  NOTTINGHA,13.42,,2925.1,Groceries,Nottingham,Uk
1232,1233,27/08/2021,CPT,LNK TESCO HK R NOT,40.0,,2938.52,Cash,Nottingham,Uk
1233,1234,27/08/2021,FPO,TRADING212UK,1500.0,,2978.52,Investment,Nottingham,Uk
1234,1235,27/08/2021,DD,TALKTALK LIMITED,21.0,,4478.52,Bills,Nottingham,Uk
1235,1236,27/08/2021,BGC,UNIV OF NOTTINGHAM,,3801.43,4499.52,Paycheck,Nottingham,Uk
1236,1237,26/08/2021,FPO,ANTIGONI ABRAHMS,6.0,,698.09,Entertainment,London,Uk
1237,1238,26/08/2021,BP,SAVE THE CHANGE,0.81,,704.09,Savings,Nottingham,Uk
1238,1239,25/08/2021,DEB,T4 TEA SALOON,14.2,,704.9,Dine Out,Nottingham,Uk
1239,1240,25/08/2021,DEB,AMZNMktplace,9.99,,719.1,Amazon,Nottingham,Uk
1240,1241,25/08/2021,FPO,TRADING212UK,300.0,,729.09,Investment,Nottingham,Uk
1241,1242,25/08/2021,FPI,ABAYOMI ADAMS,,400.0,1029.09,Supplementary Income,Nottingham,Uk
1242,1243,25/08/2021,BP,SAVE THE CHANGE,0.06,,629.09,Savings,Nottingham,Uk
1243,1244,24/08/2021,FPO,TAMBA TAM,10.0,,629.15,Services,Nottingham,Uk
1244,1245,24/08/2021,DEB,AMZNMktplace,18.95,,639.15,Amazon,Nottingham,Uk
1245,1246,24/08/2021,DEB,Audible UK,7.99,,658.1,Entertainment,Nottingham,Uk
1246,1247,24/08/2021,FPO,TRADING212UK,300.0,,666.09,Investment,Nottingham,Uk
1247,1248,24/08/2021,BP,SAVE THE CHANGE,0.21,,966.09,Savings,Nottingham,Uk
1248,1249,23/08/2021,DEB,LIDL GB  NOTTINGHA,15.79,,966.3,Groceries,Nottingham,Uk
1249,1250,23/08/2021,DEB,Amazon.co.uk*I0899,12.0,,982.09,Amazon,Nottingham,Uk
1250,1251,23/08/2021,BP,SAVE THE CHANGE,2.54,,994.09,Savings,Nottingham,Uk
1251,1252,23/08/2021,DEB,T K MAXX,21.94,,996.63,Other Shopping,,
1252,1253,23/08/2021,DEB,ORIENTAL MART HYDR,11.17,,1018.57,Groceries,Nottingham,Uk
1253,1254,23/08/2021,DEB,AMZNMktplace,5.99,,1029.74,Amazon,Nottingham,Uk
1254,1255,23/08/2021,DEB,LIDL GB  NOTTINGHA,16.09,,1035.73,Groceries,Nottingham,Uk
1255,1256,23/08/2021,DEB,AMZNMktplace,11.27,,1051.82,Amazon,Nottingham,Uk
1256,1257,20/08/2021,FPO,TRADING212UK,300.0,,1063.09,Investment,Nottingham,Uk
1257,1258,20/08/2021,FPI,SHEILA SMITH,,380.0,1363.09,Supplementary Income,Nottingham,Uk
1258,1259,20/08/2021,BP,SAVE THE CHANGE,1.01,,983.09,Savings,Nottingham,Uk
1259,1260,19/08/2021,DEB,AMZNMktplace,18.5,,984.1,Amazon,Nottingham,Uk
1260,1261,19/08/2021,DEB,HPI INSTANT INK UK,3.49,,1002.6,Other Shopping,,
1261,1262,18/08/2021,FPO,TRADING212UK,400.0,,1006.09,Investment,Nottingham,Uk
1262,1263,18/08/2021,BP,SAVE THE CHANGE,0.14,,1406.09,Savings,Nottingham,Uk
1263,1264,17/08/2021,DEB,LIDL GB  NOTTINGHA,5.86,,1406.23,Groceries,Nottingham,Uk
1264,1265,17/08/2021,DD,VIRGIN MEDIA PYMTS,25.5,,1412.09,Bills,Nottingham,Uk
1265,1266,16/08/2021,FPO,TRADING212UK,500.0,,1437.59,Investment,Nottingham,Uk
1266,1267,16/08/2021,DD,O2,16.66,,1937.59,Other Shopping,Nottingham,Uk
1267,1268,16/08/2021,BP,SAVE THE CHANGE,0.06,,1954.25,Savings,Nottingham,Uk
1268,1269,16/08/2021,DEB,AMZNMktplace,5.94,,1954.31,Amazon,Nottingham,Uk
1269,1270,11/08/2021,BP,SAVE THE CHANGE,0.1,,1960.25,Savings,Nottingham,Uk
1270,1271,10/08/2021,DEB,Amazon.co.uk*BV22U,7.9,,1960.35,Amazon,Nottingham,Uk
1271,1272,10/08/2021,BP,SAVE THE CHANGE,0.6,,1968.25,Savings,Nottingham,Uk
1272,1273,09/08/2021,DEB,Amazon.co.uk*VM9GG,14.4,,1968.85,Amazon,Nottingham,Uk
1273,1274,09/08/2021,BP,SAVE THE CHANGE,0.02,,1983.25,Savings,Nottingham,Uk
1274,1275,06/08/2021,DEB,AMZNMktplace,15.99,,1983.27,Amazon,Nottingham,Uk
1275,1276,06/08/2021,DEB,AMZNMktplace,15.99,,1999.26,Amazon,Nottingham,Uk
1276,1277,06/08/2021,DD,PURE GYM LTD,19.99,,2015.25,Fitness,Nottingham,Uk
1277,1278,05/08/2021,BP,SAVE THE CHANGE,0.21,,2035.24,Savings,Nottingham,Uk
1278,1279,04/08/2021,DEB,Amazon.co.uk*W99XU,25.8,,2035.45,Amazon,Nottingham,Uk
1279,1280,04/08/2021,DEB,AMZNMktplace,9.99,,2061.25,Amazon,Nottingham,Uk
1280,1281,04/08/2021,FPO,TRADING212UK,100.0,,2071.24,Investment,Nottingham,Uk
1281,1282,04/08/2021,BP,SAVE THE CHANGE,1.08,,2171.24,Savings,Nottingham,Uk
1282,1283,03/08/2021,DEP,CLUB LLOYDS WAIVED,,3.0,2172.32,Amazon,Nottingham,Uk
1283,1284,03/08/2021,PAY,CLUB LLOYDS FEE,3.0,,2169.32,Bills,Nottingham,Uk
1284,1285,03/08/2021,DEB,AMZNMktplace,20.99,,2172.32,Supplementary Income,Nottingham,Uk
1285,1286,03/08/2021,DEB,AMZNMktplace,14.44,,2193.31,Amazon,Nottingham,Uk
1286,1287,03/08/2021,DEB,AMZNMktplace,8.49,,2207.75,Amazon,Nottingham,Uk
1287,1288,03/08/2021,TFR,R LAWRENCE,,150.0,2216.24,Supplementary Income,Nottingham,Uk
1288,1289,02/08/2021,,INTEREST (GROSS),,0.8,2066.24,Interest,Nottingham,Uk
1289,1290,02/08/2021,FPO,TRADING212UK,500.0,,2065.44,Investment,Nottingham,Uk
1290,1291,02/08/2021,DD,BARCLAYS UK MTGES,981.71,,2565.44,Bills,Nottingham,Uk
1291,1292,02/08/2021,DD,NOTTM CITY COUNC,157.0,,3547.15,Bills,Nottingham,Uk
1292,1293,02/08/2021,DD,OCTOPUS ENERGY,90.0,,3704.15,Bills,Nottingham,Uk
1293,1294,02/08/2021,DD,SEVERN TRENT WATER,35.32,,3794.15,Bills,Nottingham,Uk
1294,1295,02/08/2021,SO,Q WANG,,1000.0,3829.47,Supplementary Income,Nottingham,Uk
1295,1296,02/08/2021,SO,ESAVINGS ACCOUNT,300.0,,2829.47,Savings,Nottingham,Uk
1296,1297,30/07/2021,FPO,TRADING212UK,1000.0,,3129.47,Investment,Nottingham,Uk
1297,1298,29/07/2021,BP,SAVE THE CHANGE,1.19,,4129.47,Savings,Nottingham,Uk
1298,1299,29/07/2021,BGC,UNIV OF NOTTINGHAM,,3756.19,4130.66,Paycheck,Nottingham,Uk
1299,1300,28/07/2021,DEB,AMZNMktplace,117.79,,374.47,Amazon,Nottingham,Uk
1300,1301,28/07/2021,DEB,LIDL GB  NOTTINGHA,14.02,,492.26,Groceries,Nottingham,Uk
1301,1302,28/07/2021,BP,SAVE THE CHANGE,0.66,,506.28,Savings,Nottingham,Uk
1302,1303,28/07/2021,FPO,TAMBA TAM,10.0,,506.94,Services,Nottingham,Uk
1303,1304,27/07/2021,DEB,UNION ROOMS,4.34,,516.94,Dine Out,Plymouth/newcatle,Uk
1304,1305,27/07/2021,DEB,CRYSTAL DRAGON,12.0,,521.28,Other Shopping,Plymouth,Uk
1305,1306,27/07/2021,FPO,TRADING212UK,400.0,,533.28,Investment,Nottingham,Uk
1306,1307,27/07/2021,DD,TALKTALK LIMITED,20.84,,933.28,Bills,Nottingham,Uk
1307,1308,27/07/2021,BP,SAVE THE CHANGE,1.82,,954.12,Savings,Nottingham,Uk
1308,1309,26/07/2021,DEB,TIGERMILK EVENTS,9.5,,955.94,Entertainment,Plymouth,Uk
1309,1310,26/07/2021,DEB,UNION ROOMS,4.34,,965.44,Dine Out,Plymouth/newcatle,Uk
1310,1311,26/07/2021,DEB,UNION ROOMS,4.34,,969.78,Dine Out,Plymouth/newcatle,Uk
1311,1312,26/07/2021,FPI,ABAYOMI ADAMS,,400.0,974.12,Supplementary Income,Nottingham,Uk
1312,1313,26/07/2021,BP,SAVE THE CHANGE,2.51,,574.12,Savings,Nottingham,Uk
1313,1314,26/07/2021,DEB,SKECHERS PLYMOUTH,67.0,,576.63,Other Shopping,Plymouth,Uk
1314,1315,26/07/2021,DEB,THE RISE BAKERY,14.75,,643.63,Dine Out,Plymouth,Uk
1315,1316,26/07/2021,CPT,LNK BOOZE BUSTERS,50.0,,658.38,Cash,Nottingham,Uk
1316,1317,26/07/2021,DEB,THE RISE BAKERY,11.15,,708.38,Dine Out,Plymouth,Uk
1317,1318,26/07/2021,DEB,Audible UK,7.99,,719.53,Entertainment,Nottingham,Uk
1318,1319,26/07/2021,DEB,PASTIES 4 YOU LTD,2.5,,727.52,Dine Out,Sheffild,Uk
1319,1320,26/07/2021,DEB,CAFFE NERO BIRMING,3.6,,730.02,Dine Out,Birmingham,Uk
1320,1321,23/07/2021,DEB,THE NEW CONTINENTA,465.0,,733.62,Dine Out,Bargoed,Uk
1321,1322,23/07/2021,DEB,EAST MIDS RAILWAY,155.5,,1198.62,Travel,Nottingham,Uk
1322,1323,23/07/2021,BP,SAVE THE CHANGE,0.01,,1354.12,Savings,Nottingham,Uk
1323,1324,23/07/2021,BGC,OPEN UNIVERSITY,,372.32,1354.13,Supplementary Income,Nottingham,Uk
1324,1325,22/07/2021,DEB,AMZNMktplace,12.99,,981.81,Amazon,Nottingham,Uk
1325,1326,22/07/2021,BP,SAVE THE CHANGE,0.83,,994.8,Savings,Nottingham,Uk
1326,1327,21/07/2021,DEB,AMZNMktplace,12.99,,995.63,Amazon,Nottingham,Uk
1327,1328,21/07/2021,DEB,LIDL GB NOTTINGHAM,8.94,,1008.62,Groceries,Nottingham,Uk
1328,1329,21/07/2021,DEB,Amazon.co.uk*228N1,5.24,,1017.56,Amazon,Nottingham,Uk
1329,1330,21/07/2021,FPO,TRADING212UK,200.0,,1022.8,Bills,Nottingham,Uk
1330,1331,21/07/2021,BP,SAVE THE CHANGE,0.08,,1222.8,Savings,Nottingham,Uk
1331,1332,20/07/2021,FPO,TAMBA TAM,10.0,,1222.88,Services,Nottingham,Uk
1332,1333,20/07/2021,FPI,SHEILA SMITH,,380.0,1232.88,Supplementary Income,Nottingham,Uk
1333,1334,20/07/2021,DEB,AMZNMktplace,102.94,,852.88,Amazon,Nottingham,Uk
1334,1335,20/07/2021,DEB,AMZNMktplace,12.99,,955.82,Amazon,Nottingham,Uk
1335,1336,20/07/2021,DEB,Amazon.co.uk*1D3K4,4.99,,968.81,Amazon,Nottingham,Uk
1336,1337,20/07/2021,BP,SAVE THE CHANGE,2.05,,973.8,Savings,Nottingham,Uk
1337,1338,19/07/2021,DEB,SAINSBURYS S/MKTS,21.55,,975.85,Groceries,,
1338,1339,19/07/2021,DEB,AMZNMktplace,11.11,,997.4,Amazon,Nottingham,Uk
1339,1340,19/07/2021,DEB,AMZNMktplace,8.75,,1008.51,Amazon,Nottingham,Uk
1340,1341,19/07/2021,DEB,AMZNMktplace,5.54,,1017.26,Amazon,Nottingham,Uk
1341,1342,19/07/2021,DD,VIRGIN MEDIA PYMTS,25.5,,1022.8,Investment,Nottingham,Uk
1342,1343,19/07/2021,BP,SAVE THE CHANGE,0.96,,1048.3,Savings,Nottingham,Uk
1343,1344,19/07/2021,FPO,TRADING212UK,150.0,,1049.26,Investment,Nottingham,Uk
1344,1345,19/07/2021,DEB,LIDL GB  NOTTINGHA,15.44,,1199.26,Groceries,Nottingham,Uk
1345,1346,19/07/2021,DEB,Audible UK,18.0,,1214.7,Entertainment,Nottingham,Uk
1346,1347,19/07/2021,DEB,SQ *DIVINE COFFEE,9.6,,1232.7,Dine Out,Nottingham,Uk
1347,1348,16/07/2021,DEB,TESCO STORES 6735,2.0,,1242.3,Groceries,,
1348,1349,16/07/2021,DD,O2,16.66,,1244.3,Other Shopping,Nottingham,Uk
1349,1350,15/07/2021,FPO,ANTIGONI ABRAHMS,6.0,,1260.96,Entertainment,London,Uk
1350,1351,15/07/2021,FPO,ALICJA ALEXANDER,30.0,,1266.96,Services/Home Improvement,Nottingham,Uk
1351,1352,15/07/2021,BP,SAVE THE CHANGE,1.08,,1296.96,Savings,Nottingham,Uk
1352,1353,14/07/2021,DEB,HPI INSTANT INK UK,3.49,,1298.04,Other Shopping,,
1353,1354,14/07/2021,DEB,LIDL GB NOTTINGHAM,11.44,,1301.53,Groceries,Nottingham,Uk
1354,1355,14/07/2021,DEB,AMZNMktplace,8.99,,1312.97,Amazon,Nottingham,Uk
1355,1356,13/07/2021,FPO,TAMBA TAM,10.0,,1321.96,Services,Nottingham,Uk
1356,1357,13/07/2021,BP,SAVE THE CHANGE,0.51,,1331.96,Savings,Nottingham,Uk
1357,1358,12/07/2021,DEB,GOOGLE *YouTube Vi,3.49,,1332.47,,Nottingham,Uk
1358,1359,12/07/2021,BP,SAVE THE CHANGE,2.12,,1335.96,Savings,Nottingham,Uk
1359,1360,12/07/2021,DEB,AMZNMktplace,9.34,,1338.08,Amazon,Nottingham,Uk
1360,1361,12/07/2021,DEB,WILKO RETAIL LIMIT,3.5,,1347.42,Other Shopping,,
1361,1362,12/07/2021,DEB,ORIENTAL MART HYDR,3.26,,1350.92,Groceries,Nottingham,Uk
1362,1363,12/07/2021,DEB,AMZNMKTPLACE AMAZO,25.99,,1354.18,Amazon,Nottingham,Uk
1363,1364,12/07/2021,FPO,ROBERT RECORD,30.0,,1380.17,Others,Nottingham,Uk
1364,1365,12/07/2021,DEB,SAINSBURYS S/MKTS,35.8,,1410.17,Groceries,,
1365,1366,09/07/2021,DEB,31K,12.0,,1445.97,Dine Out,Nottingham,Uk
1366,1367,09/07/2021,DEB,AMZNMKTPLACE AMAZO,11.99,,1457.97,Amazon,Nottingham,Uk
1367,1368,09/07/2021,BP,SAVE THE CHANGE,0.8,,1469.96,Savings,Nottingham,Uk
1368,1369,08/07/2021,FPO,ANTIGONI ABRAHMS,6.0,,1470.76,Entertainment,London,Uk
1369,1370,08/07/2021,DEB,RAJAH FOOD STORE L,6.2,,1476.76,Groceries,Nottingham,Uk
1370,1371,08/07/2021,BP,SAVE THE CHANGE,0.88,,1482.96,Savings,Nottingham,Uk
1371,1372,07/07/2021,DEB,TROPICAL SUMMER FE,114.57,,1483.84,Entertainment,Plymouth,Uk
1372,1373,07/07/2021,DEB,AMZNMktplace,98.55,,1598.41,Amazon,Nottingham,Uk
1373,1374,07/07/2021,BP,SAVE THE CHANGE,0.85,,1696.96,Savings,Nottingham,Uk
1374,1375,06/07/2021,FPO,TAMBA TAM,10.0,,1697.81,Services,Nottingham,Uk
1375,1376,06/07/2021,DEB,LIDL GB  NOTTINGHA,5.15,,1707.81,Groceries,Nottingham,Uk
1376,1377,06/07/2021,DD,PURE GYM LTD,19.99,,1712.96,Fitness,Nottingham,Uk
1377,1378,06/07/2021,BP,SAVE THE CHANGE,0.2,,1732.95,Savings,Nottingham,Uk
1378,1379,05/07/2021,DEB,LIDL GB  NOTTINGHA,11.8,,1733.15,Groceries,Nottingham,Uk
1379,1380,05/07/2021,BP,SAVE THE CHANGE,2.11,,1744.95,Savings,Nottingham,Uk
1380,1381,05/07/2021,DEB,Lush UK,36.0,,1747.06,Other Shopping,,
1381,1382,05/07/2021,DEB,ORIENTAL MART HYDR,11.01,,1783.06,Groceries,Nottingham,Uk
1382,1383,05/07/2021,DEB,DOUGHNOTTS BAKERY,6.5,,1794.07,Dine Out,Nottingham,Uk
1383,1384,05/07/2021,DEB,LIDL GB  NOTTINGHA,18.39,,1800.57,Groceries,Nottingham,Uk
1384,1385,02/07/2021,DEP,CLUB LLOYDS WAIVED,,3.0,1818.96,Amazon,Nottingham,Uk
1385,1386,02/07/2021,PAY,CLUB LLOYDS FEE,3.0,,1815.96,Bills,Nottingham,Uk
1386,1387,02/07/2021,DEB,AMZNMktplace,14.99,,1818.96,Supplementary Income,Nottingham,Uk
1387,1388,02/07/2021,DEB,31K,12.0,,1833.95,Dine Out,Nottingham,Uk
1388,1389,01/07/2021,,INTEREST (GROSS),,0.63,1845.95,Interest,Nottingham,Uk
1389,1390,01/07/2021,FPO,ALICJA ALEXANDER,30.0,,1845.32,Services/Home Improvement,Nottingham,Uk
1390,1391,01/07/2021,FPO,ANTIGONI ABRAHMS,6.0,,1875.32,Entertainment,London,Uk
1391,1392,01/07/2021,FPO,TRADING212UK,500.0,,1881.32,Investment,Nottingham,Uk
1392,1393,01/07/2021,DD,BARCLAYS UK MTGES,981.71,,2381.32,Bills,Nottingham,Uk
1393,1394,01/07/2021,DD,NOTTM CITY COUNC,157.0,,3363.03,Bills,Nottingham,Uk
1394,1395,01/07/2021,DD,OCTOPUS ENERGY,90.0,,3520.03,Bills,Nottingham,Uk
1395,1396,01/07/2021,DD,SEVERN TRENT WATER,35.22,,3610.03,Bills,Nottingham,Uk
1396,1397,01/07/2021,SO,Q WANG,,1000.0,3645.25,Supplementary Income,Nottingham,Uk
1397,1398,01/07/2021,SO,ESAVINGS ACCOUNT,300.0,,2645.25,Savings,Nottingham,Uk
1398,1399,01/07/2021,BP,SAVE THE CHANGE,0.31,,2945.25,Savings,Nottingham,Uk
1399,1400,30/06/2021,DEB,LIDL GB NOTTINGHAM,10.69,,2945.56,Groceries,Nottingham,Uk
1400,1401,29/06/2021,FPO,TRADING212UK,1100.0,,2956.25,Investment,Nottingham,Uk
1401,1402,29/06/2021,BP,SAVE THE CHANGE,0.12,,4056.25,Savings,Nottingham,Uk
1402,1403,29/06/2021,BGC,UNIV OF NOTTINGHAM,,3756.18,4056.37,Paycheck,Nottingham,Uk
1403,1404,28/06/2021,DEB,Amazon.co.uk*200PY,29.99,,300.19,Amazon,Nottingham,Uk
1404,1405,28/06/2021,DEB,LIDL GB  NOTTINGHA,14.89,,330.18,Groceries,Nottingham,Uk
1405,1406,28/06/2021,FPO,JOE SPENCE,26.0,,345.07,Services,Nottingham,Uk
1406,1407,28/06/2021,BP,SAVE THE CHANGE,2.14,,371.07,Savings,Nottingham,Uk
1407,1408,28/06/2021,DEB,ORIENTAL MART HYDR,11.21,,373.21,Groceries,Nottingham,Uk
1408,1409,28/06/2021,DEB,AMZNMktplace,7.49,,384.42,Amazon,Nottingham,Uk
1409,1410,28/06/2021,FPO,ROBERT RECORD,120.0,,391.91,Others,Nottingham,Uk
1410,1411,28/06/2021,DEB,AMZNMktplace,39.98,,511.91,Amazon,Nottingham,Uk
1411,1412,25/06/2021,DEB,STARBUCKS,8.18,,551.89,Dine Out,,
1412,1413,25/06/2021,DD,TALKTALK LIMITED,21.95,,560.07,Bills,Nottingham,Uk
1413,1414,25/06/2021,BP,SAVE THE CHANGE,1.37,,582.02,Savings,Nottingham,Uk
1414,1415,24/06/2021,FPO,ANTIGONI ABRAHMS,6.0,,583.39,Entertainment,London,Uk
1415,1416,24/06/2021,DEB,Amazon.co.uk*284VM,39.99,,589.39,Amazon,Nottingham,Uk
1416,1417,24/06/2021,DEB,LIDL GB  NOTTINGHA,15.06,,629.38,Groceries,Nottingham,Uk
1417,1418,24/06/2021,DEB,AMZNMktplace,9.59,,644.44,Amazon,Nottingham,Uk
1418,1419,24/06/2021,DEB,Audible UK,7.99,,654.03,Entertainment,Nottingham,Uk
1419,1420,24/06/2021,FPO,TRADING212UK,300.0,,662.02,Investment,Nottingham,Uk
1420,1421,24/06/2021,FPI,ABAYOMI ADAMS,,400.0,962.02,Supplementary Income,Nottingham,Uk
1421,1422,24/06/2021,BP,SAVE THE CHANGE,1.08,,562.02,Savings,Nottingham,Uk
1422,1423,23/06/2021,DEB,AMZNMktplace,22.33,,563.1,Amazon,Nottingham,Uk
1423,1424,23/06/2021,DEB,STARBUCKS,4.59,,585.43,Dine Out,,
1424,1425,23/06/2021,FPO,TRADING212UK,100.0,,590.02,Investment,Nottingham,Uk
1425,1426,23/06/2021,FPO,RAC ELECTRICAL CON,150.0,,690.02,Home Improvement,Nottingham,Uk
1426,1427,23/06/2021,BP,SAVE THE CHANGE,1.02,,840.02,Savings,Nottingham,Uk
1427,1428,22/06/2021,DEB,AMZNMktplace,40.08,,841.04,Amazon,Nottingham,Uk
1428,1429,22/06/2021,DEB,AMZNMktplace,11.9,,881.12,Amazon,Nottingham,Uk
1429,1430,22/06/2021,BP,SAVE THE CHANGE,0.49,,893.02,Savings,Nottingham,Uk
1430,1431,21/06/2021,DEB,AMZNMktplace,9.99,,893.51,Amazon,Nottingham,Uk
1431,1432,21/06/2021,DEB,LIDL GB  NOTTINGHA,9.52,,903.5,Groceries,Nottingham,Uk
1432,1433,21/06/2021,FPO,TRADING212UK,200.0,,913.02,Investment,Nottingham,Uk
1433,1434,21/06/2021,BP,SAVE THE CHANGE,2.95,,1113.02,Savings,Nottingham,Uk
1434,1435,21/06/2021,FPI,SHEILA SMITH,,380.0,1115.97,Supplementary Income,Nottingham,Uk
1435,1436,21/06/2021,DEB,AMZNMktplace,21.89,,735.97,Amazon,Nottingham,Uk
1436,1437,21/06/2021,DEB,AMZNMktplace,19.95,,757.86,Amazon,Nottingham,Uk
1437,1438,21/06/2021,DEB,ORIENTAL MART HYDR,10.37,,777.81,Groceries,Nottingham,Uk
1438,1439,21/06/2021,DEB,DOUGHNOTTS BAKERY,5.5,,788.18,Dine Out,Nottingham,Uk
1439,1440,21/06/2021,DEB,WILKO RETAIL LIMIT,2.5,,793.68,Other Shopping,,
1440,1441,21/06/2021,DEB,LIDL GB NOTTINGHAM,8.25,,796.18,Groceries,Nottingham,Uk
1441,1442,21/06/2021,DEB,STARBUCKS,4.59,,804.43,Dine Out,,
1442,1443,18/06/2021,DEB,YOLK.,12.0,,809.02,Dine Out,Nottingham,Uk
1443,1444,18/06/2021,BP,SAVE THE CHANGE,0.3,,821.02,Savings,Nottingham,Uk
1444,1445,17/06/2021,FPO,ALICJA ALEXANDER,30.0,,821.32,Services/Home Improvement,Nottingham,Uk
1445,1446,17/06/2021,FPO,ANTIGONI ABRAHMS,6.0,,851.32,Entertainment,London,Uk
1446,1447,17/06/2021,DEB,AMZNMktplace,13.99,,857.32,Amazon,Nottingham,Uk
1447,1448,17/06/2021,DEB,LIDL GB  NOTTINGHA,6.71,,871.31,Groceries,Nottingham,Uk
1448,1449,17/06/2021,DD,VIRGIN MEDIA PYMTS,25.5,,878.02,Bills,Nottingham,Uk
1449,1450,17/06/2021,BP,SAVE THE CHANGE,0.66,,903.52,Savings,Nottingham,Uk
1450,1451,16/06/2021,DEB,AMZNMktplace,160.76,,904.18,Amazon,Nottingham,Uk
1451,1452,16/06/2021,DEB,AMZNMKTPLACE AMAZO,21.99,,1064.94,Amazon,Nottingham,Uk
1452,1453,16/06/2021,DEB,STARBUCKS,4.59,,1086.93,Dine Out,,
1453,1454,16/06/2021,DD,O2,19.86,,1091.52,Other Shopping,Nottingham,Uk
1454,1455,16/06/2021,BP,SAVE THE CHANGE,1.87,,1111.38,Savings,Nottingham,Uk
1455,1456,15/06/2021,DEB,AMZNMktplace,33.0,,1113.25,Amazon,Nottingham,Uk
1456,1457,15/06/2021,DEB,SHARIF AND SONS SU,26.82,,1146.25,Groceries,Derby,Uk
1457,1458,15/06/2021,DEB,SOLO GRANO,16.01,,1173.07,Dine Out,Nottingham,Uk
1458,1459,15/06/2021,DEB,AMZNMktplace,4.79,,1189.08,Amazon,Nottingham,Uk
1459,1460,15/06/2021,DEB,AMZNMktplace,3.51,,1193.87,Amazon,Nottingham,Uk
1460,1461,15/06/2021,FPO,STEWART SCHOFIELD,150.0,,1197.38,Services,Nottingham,Uk
1461,1462,15/06/2021,BP,SAVE THE CHANGE,0.73,,1347.38,Savings,Nottingham,Uk
1462,1463,14/06/2021,DEB,LIDL GB  NOTTINGHA,14.79,,1348.11,Groceries,Nottingham,Uk
1463,1464,14/06/2021,DEB,HPI INSTANT INK UK,4.49,,1362.9,Other Shopping,,
1464,1465,14/06/2021,DEB,ZARA NOTTINGHAM,19.99,,1367.39,Clothes,Nottingham,Uk
1465,1466,14/06/2021,BP,SAVE THE CHANGE,2.04,,1387.38,Savings,Nottingham,Uk
1466,1467,14/06/2021,DEB,ORIENTAL MART HYDR,11.17,,1389.42,Groceries,Nottingham,Uk
1467,1468,14/06/2021,DEB,DOUGHNOTTS BAKERY,6.5,,1400.59,Dine Out,Nottingham,Uk
1468,1469,14/06/2021,FPO,TRADING212UK,200.0,,1407.09,Investment,Nottingham,Uk
1469,1470,14/06/2021,DEB,ECOTRICITY,139.51,,1607.09,Home Improvement,Nottingham,Uk
1470,1471,14/06/2021,DEB,SAINSBURYS S/MKTS,37.78,,1746.6,Groceries,,
1471,1472,11/06/2021,FPI,SHEILA SMITH,,400.0,1784.38,Supplementary Income,Nottingham,Uk
1472,1473,11/06/2021,BP,SAVE THE CHANGE,1.13,,1384.38,Savings,Nottingham,Uk
1473,1474,10/06/2021,FPO,ANTIGONI ABRAHMS,6.0,,1385.51,Entertainment,London,Uk
1474,1475,10/06/2021,DEB,AMZNMktplace,77.7,,1391.51,Amazon,Nottingham,Uk
1475,1476,10/06/2021,DEB,LIDL GB  NOTTINGHA,12.17,,1469.21,Groceries,Nottingham,Uk
1476,1477,10/06/2021,BP,SAVE THE CHANGE,1.81,,1481.38,Savings,Nottingham,Uk
1477,1478,09/06/2021,DEB,AMZNMktplace,43.93,,1483.19,Amazon,Nottingham,Uk
1478,1479,09/06/2021,DEB,STARBUCKS CAFE,7.18,,1527.12,Dine Out,,
1479,1480,09/06/2021,DEB,SEVERN TRENT WATER,6.34,,1534.3,Bills,Nottingham,Uk
1480,1481,09/06/2021,DEB,AMZNMKTPLACE AMAZO,31.74,,1540.64,Amazon,Nottingham,Uk
1481,1482,08/06/2021,BP,SAVE THE CHANGE,0.01,,1572.38,Savings,Nottingham,Uk
1482,1483,07/06/2021,DEB,PureGym Limited,19.99,,1572.39,Fitness,Nottingham,Uk
1483,1484,07/06/2021,BP,SAVE THE CHANGE,0.93,,1592.38,Savings,Nottingham,Uk
1484,1485,07/06/2021,DEB,T K MAXX,16.99,,1593.31,Other Shopping,,
1485,1486,07/06/2021,DEB,ORIENTAL MART HYDR,9.8,,1610.3,Groceries,Nottingham,Uk
1486,1487,07/06/2021,DEB,DOUGHNOTTS BAKERY,6.5,,1620.1,Dine Out,Nottingham,Uk
1487,1488,07/06/2021,DEB,LIDL GB  NOTTINGHA,8.78,,1626.6,Groceries,Nottingham,Uk
1488,1489,04/06/2021,DEP,CLUB LLOYDS WAIVED,,3.0,1635.38,Supplementary Income,Nottingham,Uk
1489,1490,04/06/2021,PAY,CLUB LLOYDS FEE,3.0,,1632.38,Bills,Nottingham,Uk
1490,1491,04/06/2021,FPO,ROBERT RECORD,30.0,,1635.38,Others,Nottingham,Uk
1491,1492,04/06/2021,BP,SAVE THE CHANGE,0.16,,1665.38,Savings,Nottingham,Uk
1492,1493,03/06/2021,DEB,LIDL GB  NOTTINGHA,14.84,,1665.54,Groceries,Nottingham,Uk
1493,1494,03/06/2021,FPO,ALICJA ALEXANDER,30.0,,1680.38,Services/Home Improvement,Nottingham,Uk
1494,1495,02/06/2021,BP,SAVE THE CHANGE,0.5,,1710.38,Savings,Nottingham,Uk
1495,1496,01/06/2021,,INTEREST (GROSS),,0.62,1710.88,Interest,Nottingham,Uk
1496,1497,01/06/2021,FPO,TAMBA TAM,10.0,,1710.26,Services,Nottingham,Uk
1497,1498,01/06/2021,DEB,Lush UK,20.0,,1720.26,Other Shopping,,
1498,1499,01/06/2021,DEB,SUMMERS IN TIME DA,6.0,,1740.26,Others,Nottingham,Uk
1499,1500,01/06/2021,DEB,PIZZAMISU,18.5,,1746.26,Dine Out,Nottingham,Uk
1500,1501,01/06/2021,FPO,TRADING212UK,500.0,,1764.76,Investment,Nottingham,Uk
1501,1502,01/06/2021,DD,BARCLAYS UK MTGES,981.71,,2264.76,Bills,Nottingham,Uk
1502,1503,01/06/2021,DD,NOTTM CITY COUNC,157.0,,3246.47,Bills,Nottingham,Uk
1503,1504,01/06/2021,DD,OCTOPUS ENERGY,90.0,,3403.47,Bills,Nottingham,Uk
1504,1505,01/06/2021,SO,Q WANG,,1000.0,3493.47,Supplementary Income,Nottingham,Uk
1505,1506,01/06/2021,SO,ESAVINGS ACCOUNT,300.0,,2493.47,Savings,Nottingham,Uk
1506,1507,01/06/2021,BP,SAVE THE CHANGE,3.27,,2793.47,Savings,Nottingham,Uk
1507,1508,01/06/2021,DEB,LIDL GB  NOTTINGHA,12.24,,2796.74,Groceries,Nottingham,Uk
1508,1509,01/06/2021,DEB,AMZNMktplace,8.68,,2808.98,Amazon,Nottingham,Uk
1509,1510,01/06/2021,DEB,ORIENTAL MART HYDR,20.19,,2817.66,Groceries,Nottingham,Uk
1510,1511,01/06/2021,DEB,WILKO RETAIL LIMIT,9.0,,2837.85,Other Shopping,,
1511,1512,01/06/2021,DEB,DOUGHNOTTS BAKERY,6.5,,2846.85,Dine Out,Nottingham,Uk
1512,1513,01/06/2021,DEB,GREGGS PLC,2.0,,2853.35,Dine Out,,
1513,1514,01/06/2021,TFR,R LAWRENCE  29MAY21,,900.0,2855.35,Supplementary Income,Nottingham,Uk
1514,1515,01/06/2021,FPO,STEWART SCHOFIELD,850.0,,1955.35,Services,Nottingham,Uk
1515,1516,01/06/2021,DEB,AMZNMktplace,13.99,,2805.35,Amazon,Nottingham,Uk
1516,1517,01/06/2021,DEB,AMZNMktplace,11.18,,2819.34,Amazon,Nottingham,Uk
1517,1518,28/05/2021,DEB,AMZNMktplace,79.95,,2830.52,Amazon,Nottingham,Uk
1518,1519,28/05/2021,DEB,SUMMERS IN TIME DA,6.0,,2910.47,Others,Nottingham,Uk
1519,1520,28/05/2021,DD,TALKTALK LIMITED,21.95,,2916.47,Bills,Nottingham,Uk
1520,1521,28/05/2021,BP,SAVE THE CHANGE,0.68,,2938.42,Savings,Nottingham,Uk
1521,1522,27/05/2021,DEB,IZ *Nottingham Bik,50.0,,2939.1,Other Shopping,Nottingham,Uk
1522,1523,27/05/2021,DEB,LIDL GB  NOTTINGHA,10.32,,2989.1,Groceries,Nottingham,Uk
1523,1524,27/05/2021,FPO,TRADING212UK,1300.0,,2999.42,Investment,Nottingham,Uk
1524,1525,27/05/2021,BP,SAVE THE CHANGE,1.22,,4299.42,Savings,Nottingham,Uk
1525,1526,27/05/2021,BGC,UNIV OF NOTTINGHAM,,3756.18,4300.64,Paycheck,Nottingham,Uk
1526,1527,26/05/2021,DEB,AMZNMktplace,8.9,,544.46,Amazon,Nottingham,Uk
1527,1528,26/05/2021,DEB,AMZNMktplace,8.03,,553.36,Amazon,Nottingham,Uk
1528,1529,26/05/2021,DEB,LIDL GB  NOTTINGHA,5.85,,561.39,Groceries,Nottingham,Uk
1529,1530,26/05/2021,BP,SAVE THE CHANGE,0.01,,567.24,Savings,Nottingham,Uk
1530,1531,25/05/2021,FPO,TAMBA TAM,10.0,,567.25,Services,Nottingham,Uk
1531,1532,25/05/2021,DEB,AMZNMktplace,27.99,,577.25,Amazon,Nottingham,Uk
1532,1533,25/05/2021,BP,SAVE THE CHANGE,0.01,,605.24,Savings,Nottingham,Uk
1533,1534,24/05/2021,DEB,Audible UK,7.99,,605.25,Entertainment,Nottingham,Uk
1534,1535,24/05/2021,FPO,TRADING212UK,400.0,,613.24,Savings,Nottingham,Uk
1535,1536,24/05/2021,FPI,ABAYOMI ADAMS,,400.0,1013.24,Supplementary Income,Nottingham,Uk
1536,1537,24/05/2021,BP,SAVE THE CHANGE,2.94,,613.24,Investment,Nottingham,Uk
1537,1538,24/05/2021,DEB,LIDL GB  NOTTINGHA,13.59,,616.18,Groceries,Nottingham,Uk
1538,1539,24/05/2021,DEB,DOUGHNOTTS BAKERY,6.5,,629.77,Dine Out,Nottingham,Uk
1539,1540,24/05/2021,DEB,ORIENTAL MART HYDR,5.03,,636.27,Groceries,Nottingham,Uk
1540,1541,24/05/2021,DEB,WILKO RETAIL LIMIT,2.5,,641.3,Other Shopping,,
1541,1542,21/05/2021,DEB,LIDL GB  NOTTINGHA,8.44,,643.8,Groceries,Nottingham,Uk
1542,1543,20/05/2021,FPO,TRADING212UK,100.0,,652.24,Investment,Nottingham,Uk
1543,1544,20/05/2021,FPO,ALICJA ALEXANDER,30.0,,752.24,Services/Home Improvement,Nottingham,Uk
1544,1545,20/05/2021,BP,SAVE THE CHANGE,0.87,,782.24,Savings,Nottingham,Uk
1545,1546,19/05/2021,DEB,AMZNMktplace,15.99,,783.11,Amazon,Nottingham,Uk
1546,1547,19/05/2021,DEB,AMAZON.CO.UK*MK3GT,10.14,,799.1,Amazon,Nottingham,Uk
1547,1548,19/05/2021,BP,SAVE THE CHANGE,0.32,,809.24,Savings,Nottingham,Uk
1548,1549,18/05/2021,FPO,TAMBA TAM,10.0,,809.56,Services,Nottingham,Uk
1549,1550,18/05/2021,DEB,LIDL GB  NOTTINGHA,15.68,,819.56,Groceries,Nottingham,Uk
1550,1551,18/05/2021,DEB,SUMMERS IN TIME DA,6.0,,835.24,Others,Nottingham,Uk
1551,1552,18/05/2021,CPT,LNK NOTTINGHAM UNI,40.0,,841.24,Cash,Nottingham,Uk
1552,1553,17/05/2021,DD,VIRGIN MEDIA PYMTS,25.5,,881.24,Bills,Nottingham,Uk
1553,1554,17/05/2021,DD,O2,16.66,,906.74,Other Shopping,Nottingham,Uk
1554,1555,17/05/2021,BP,SAVE THE CHANGE,1.56,,923.4,Savings,Nottingham,Uk
1555,1556,17/05/2021,DEB,ORIENTAL MART HYDR,9.77,,924.96,Groceries,Nottingham,Uk
1556,1557,17/05/2021,DEB,LIDL GB  NOTTINGHA,5.27,,934.73,Groceries,Nottingham,Uk
1557,1558,14/05/2021,DEB,AMZNMktplace,39.99,,940.0,Amazon,Nottingham,Uk
1558,1559,14/05/2021,DEB,LIDL GB  NOTTINGHA,16.93,,979.99,Groceries,Nottingham,Uk
1559,1560,14/05/2021,DEB,HPI INSTANT INK UK,3.49,,996.92,Other Shopping,,
1560,1561,14/05/2021,DEB,AMAZON.CO.UK*MK65X,9.99,,1000.41,Amazon,Nottingham,Uk
1561,1562,14/05/2021,DEB,SKYPE.COM/GO/BILL,5.0,,1010.4,Bills,Nottingham,Uk
1562,1563,14/05/2021,BP,SAVE THE CHANGE,0.13,,1015.4,Savings,Nottingham,Uk
1563,1564,13/05/2021,DEB,AMZNMktplace,2.87,,1015.53,Amazon,Nottingham,Uk
1564,1565,13/05/2021,BP,SAVE THE CHANGE,0.66,,1018.4,Savings,Nottingham,Uk
1565,1566,12/05/2021,DEB,LIDL GB  NOTTINGHA,18.34,,1019.06,Groceries,Nottingham,Uk
1566,1567,12/05/2021,BP,SAVE THE CHANGE,0.01,,1037.4,Savings,Nottingham,Uk
1567,1568,11/05/2021,FPO,ROBERT RECORD,105.0,,1037.41,Others,Nottingham,Uk
1568,1569,11/05/2021,DEB,AMZNMktplace,9.99,,1142.41,Amazon,Nottingham,Uk
1569,1570,11/05/2021,FPO,PATRICIA A S LAW,300.0,,1152.4,Other Shopping,,
1570,1571,11/05/2021,BP,SAVE THE CHANGE,0.1,,1452.4,Savings,Nottingham,Uk
1571,1572,10/05/2021,DEB,AMZNMktplace,13.99,,1452.5,Amazon,Nottingham,Uk
1572,1573,10/05/2021,DEB,SOLO GRANO,3.91,,1466.49,Dine Out,Nottingham,Uk
1573,1574,10/05/2021,BP,SAVE THE CHANGE,4.27,,1470.4,Savings,Nottingham,Uk
1574,1575,10/05/2021,DEB,ORIENTAL MART HYDR,10.34,,1474.67,Groceries,Nottingham,Uk
1575,1576,10/05/2021,DEB,T K MAXX,8.97,,1485.01,Other Shopping,,
1576,1577,10/05/2021,DEB,Amazon.co.uk*MK585,6.49,,1493.98,Amazon,Nottingham,Uk
1577,1578,10/05/2021,DEB,PP*DOUGHNOTTS,6.0,,1500.47,Dine Out,Nottingham,Uk
1578,1579,10/05/2021,FPO,ANTIGONI ABRAHMS,5.0,,1506.47,Entertainment,London,Uk
1579,1580,10/05/2021,DEB,SHARIF AND SONS SU,7.29,,1511.47,Groceries,Derby,Uk
1580,1581,10/05/2021,DEB,AMZNMktplace,3.03,,1518.76,Amazon,Nottingham,Uk
1581,1582,07/05/2021,DEB,LIDL GB  NOTTINGHA,11.12,,1521.79,Groceries,Nottingham,Uk
1582,1583,07/05/2021,DEB,AMZNMktplace,2.49,,1532.91,Amazon,Nottingham,Uk
1583,1584,07/05/2021,DD,OCTOPUS ENERGY,90.0,,1535.4,Bills,Nottingham,Uk
1584,1585,07/05/2021,BP,SAVE THE CHANGE,1.24,,1625.4,Savings,Nottingham,Uk
1585,1586,06/05/2021,FPO,ALICJA ALEXANDER,30.0,,1626.64,Services/Home Improvement,Nottingham,Uk
1586,1587,06/05/2021,DEB,CLASSIC DOORS AND,78.0,,1656.64,Home Improvement,Nottingham,Uk
1587,1588,06/05/2021,DEB,Amazon.co.uk*MK78E,17.58,,1734.64,Amazon,Nottingham,Uk
1588,1589,06/05/2021,DEB,LIDL GB  NOTTINGHA,11.18,,1752.22,Groceries,Nottingham,Uk
1589,1590,06/05/2021,BP,SAVE THE CHANGE,0.97,,1763.4,Savings,Nottingham,Uk
1590,1591,05/05/2021,DEP,CLUB LLOYDS WAIVED,,3.0,1764.37,Amazon,Nottingham,Uk
1591,1592,05/05/2021,PAY,CLUB LLOYDS FEE,3.0,,1761.37,Bills,Nottingham,Uk
1592,1593,05/05/2021,DEB,AMZNMktplace,29.95,,1764.37,Supplementary Income,Nottingham,Uk
1593,1594,05/05/2021,DEB,AMZNMktplace,15.99,,1794.32,Amazon,Nottingham,Uk
1594,1595,05/05/2021,DEB,AMAZON.CO.UK*MK9J0,15.09,,1810.31,Amazon,Nottingham,Uk
1595,1596,05/05/2021,DEB,Amazon.co.uk*MK602,6.0,,1825.4,Amazon,Nottingham,Uk
1596,1597,05/05/2021,BP,SAVE THE CHANGE,0.2,,1831.4,Savings,Nottingham,Uk
1597,1598,04/05/2021,,INTEREST (GROSS),,0.74,1831.6,Interest,Nottingham,Uk
1598,1599,04/05/2021,DEB,CAFFE NERO 650 NOT,2.8,,1830.86,Dine Out,Nottingham,Uk
1599,1600,04/05/2021,FPO,TRADING212UK,600.0,,1833.66,Investment,Nottingham,Uk
1600,1601,04/05/2021,TFR,R LAWRENCE,,200.0,2433.66,Supplementary Income,Nottingham,Uk
1601,1602,04/05/2021,DD,BARCLAYS UK MTGES,981.71,,2233.66,Bills,Nottingham,Uk
1602,1603,04/05/2021,DD,NOTTM CITY COUNC,155.06,,3215.37,Bills,Nottingham,Uk
1603,1604,04/05/2021,SO,Q WANG,,1000.0,3370.43,Supplementary Income,Nottingham,Uk
1604,1605,04/05/2021,SO,ESAVINGS ACCOUNT,300.0,,2370.43,Savings,Nottingham,Uk
1605,1606,04/05/2021,BP,SAVE THE CHANGE,2.23,,2670.43,Savings,Nottingham,Uk
1606,1607,04/05/2021,DEB,PP*DOUGHNOTTS,6.5,,2672.66,Dine Out,Nottingham,Uk
1607,1608,04/05/2021,FPO,ROBERT RECORD,45.0,,2679.16,Others,Nottingham,Uk
1608,1609,04/05/2021,DEB,ORIENTAL MART HYDR,14.25,,2724.16,Groceries,Nottingham,Uk
1609,1610,04/05/2021,DEB,WILKO RETAIL LIMIT,6.0,,2738.41,Other Shopping,,
1610,1611,04/05/2021,DEB,SOLO GRANO,3.47,,2744.41,Dine Out,Nottingham,Uk
1611,1612,04/05/2021,DEB,LIDL GB  NOTTINGHA,12.88,,2747.88,Groceries,Nottingham,Uk
1612,1613,04/05/2021,DEB,AMZNMKTPLACE AMAZO,5.67,,2760.76,Amazon,Nottingham,Uk
1613,1614,04/05/2021,FPO,ANTIGONI ABRAHMS,5.0,,2766.43,Entertainment,London,Uk
1614,1615,30/04/2021,DEB,AMAZON.CO.UK*MK74Z,3.0,,2771.43,Amazon,Nottingham,Uk
1615,1616,30/04/2021,BP,SAVE THE CHANGE,1.51,,2774.43,Savings,Nottingham,Uk
1616,1617,29/04/2021,DEB,ECOTRICITY,130.61,,2775.94,Home Improvement,Nottingham,Uk
1617,1618,29/04/2021,DEB,LIDL GB  NOTTINGHA,12.19,,2906.55,Groceries,Nottingham,Uk
1618,1619,29/04/2021,DEB,AMZNMKTPLACE AMAZO,2.69,,2918.74,Amazon,Nottingham,Uk
1619,1620,29/04/2021,FPO,TRADING212UK,1000.0,,2921.43,Investment,Nottingham,Uk
1620,1621,29/04/2021,FPO,TRADING212UK,293.0,,3921.43,Investment,Nottingham,Uk
1621,1622,29/04/2021,BGC,UNIV OF NOTTINGHAM,,3756.59,4214.43,Paycheck,Nottingham,Uk
1622,1623,28/04/2021,FPO,TRADING212UK,100.0,,457.84,Investment,Nottingham,Uk
1623,1624,28/04/2021,FPO,MR IAN ELLIS,110.0,,557.84,Services,Nottingham,Uk
1624,1625,28/04/2021,BP,SAVE THE CHANGE,0.35,,667.84,Savings,Nottingham,Uk
1625,1626,27/04/2021,DEB,SHARIF AND SONS SU,19.65,,668.19,Groceries,Derby,Uk
1626,1627,27/04/2021,DD,TALKTALK LIMITED,21.95,,687.84,Bills,Nottingham,Uk
1627,1628,26/04/2021,FPO,TRADING212UK,200.0,,709.79,Investment,Nottingham,Uk
1628,1629,26/04/2021,BP,SAVE THE CHANGE,3.67,,909.79,Savings,Nottingham,Uk
1629,1630,26/04/2021,DEB,EAST MIDS RAILWAY,19.4,,913.46,Travel,Nottingham,Uk
1630,1631,26/04/2021,DEB,LIDL GB  NOTTINGHA,9.3,,932.86,Groceries,Nottingham,Uk
1631,1632,26/04/2021,DEB,AMZNMktplace,14.99,,942.16,Amazon,Nottingham,Uk
1632,1633,26/04/2021,DEB,Amazon.co.uk*M40A6,10.81,,957.15,Amazon,Nottingham,Uk
1633,1634,26/04/2021,DEB,Audible UK,7.99,,967.96,Entertainment,Nottingham,Uk
1634,1635,26/04/2021,DEB,AMZNMktplace,3.22,,975.95,Amazon,Nottingham,Uk
1635,1636,26/04/2021,DEB,AMZNMKTPLACE AMAZO,4.48,,979.17,Amazon,Nottingham,Uk
1636,1637,26/04/2021,FPI,ABAYOMI ADAMS,,400.0,983.65,Supplementary Income,Nottingham,Uk
1637,1638,23/04/2021,DEB,AMZNMktplace,100.8,,583.65,Amazon,Nottingham,Uk
1638,1639,23/04/2021,DEB,SAINSBURYS S/MKT,38.79,,684.45,Groceries,Nottingham,Uk
1639,1640,23/04/2021,DEB,AMAZON.CO.UK*M44AQ,26.55,,723.24,Amazon,Nottingham,Uk
1640,1641,23/04/2021,BGC,GOOGLE IRELAND,,61.27,749.79,Supplementary Income,Nottingham,Uk
1641,1642,22/04/2021,FPO,TRADING212UK,200.0,,688.52,Investment,Nottingham,Uk
1642,1643,22/04/2021,FPI,MARK NEAL WINSTEIN,,395.51,888.52,Supplementary Income,Nottingham,Uk
1643,1644,22/04/2021,BP,SAVE THE CHANGE,0.73,,493.01,Savings,Nottingham,Uk
1644,1645,21/04/2021,DEB,LIDL GB  NOTTINGHA,15.27,,493.74,Groceries,Nottingham,Uk
1645,1646,20/04/2021,FPO,ALICJA ALEXANDER,25.0,,509.01,Services/Home Improvement,Nottingham,Uk
1646,1647,20/04/2021,BP,SAVE THE CHANGE,0.51,,534.01,Savings,Nottingham,Uk
1647,1648,19/04/2021,DEB,AMZNMktplace,6.99,,534.52,Amazon,Nottingham,Uk
1648,1649,19/04/2021,DEB,PP*DOUGHNOTTS,6.5,,541.51,Dine Out,Nottingham,Uk
1649,1650,19/04/2021,DD,VIRGIN MEDIA PYMTS,25.5,,548.01,Bills,Nottingham,Uk
1650,1651,19/04/2021,BP,SAVE THE CHANGE,1.06,,573.51,Savings,Nottingham,Uk
1651,1652,19/04/2021,DEB,T K MAXX,41.96,,574.57,Other Shopping,Nottingham,Uk
1652,1653,19/04/2021,DEB,ORIENTAL MART HYDR,7.48,,616.53,Groceries,Nottingham,Uk
1653,1654,19/04/2021,DEB,WILKO RETAIL LIMIT,4.5,,624.01,Other Shopping,Nottingham,Uk
1654,1655,19/04/2021,FPO,ANTIGONI ABRAHMS,5.0,,628.51,Entertainment,London,Uk
1655,1656,16/04/2021,DD,O2,16.66,,633.51,Other Shopping,Nottingham,Uk
1656,1657,16/04/2021,BP,SAVE THE CHANGE,0.91,,650.17,Savings,Nottingham,Uk
1657,1658,15/04/2021,DEB,AMAZON.CO.UK*M46EG,69.09,,651.08,Amazon,Nottingham,Uk
1658,1659,15/04/2021,BP,SAVE THE CHANGE,0.7,,720.17,Savings,Nottingham,Uk
1659,1660,14/04/2021,DEB,LIDL GB  NOTTINGHA,16.3,,720.87,Groceries,Nottingham,Uk
1660,1661,14/04/2021,FPO,MR IAN ELLIS,255.0,,737.17,Services,Nottingham,Uk
1661,1662,14/04/2021,BP,SAVE THE CHANGE,0.51,,992.17,Savings,Nottingham,Uk
1662,1663,13/04/2021,DEB,HPI INSTANT INK UK,3.49,,992.68,Other Shopping,,
1663,1664,13/04/2021,BP,SAVE THE CHANGE,1.6,,996.17,Savings,Nottingham,Uk
1664,1665,12/04/2021,DEB,SOLO GRANO,3.05,,997.77,Dine Out,Nottingham,Uk
1665,1666,12/04/2021,DEB,TESCO STORES 5954,2.0,,1000.82,Groceries,,
1666,1667,12/04/2021,DEB,CAFFE NERO 650 NOT,3.35,,1002.82,Dine Out,Nottingham,Uk
1667,1668,12/04/2021,BP,SAVE THE CHANGE,1.35,,1006.17,Savings,Nottingham,Uk
1668,1669,12/04/2021,DEB,ORIENTAL MART HYDR,13.91,,1007.52,Groceries,Nottingham,Uk
1669,1670,12/04/2021,DEB,TESCO STORE 2960,10.09,,1021.43,Groceries,,
1670,1671,12/04/2021,DEB,WWW.DOUGHN* DOUGHN,6.8,,1031.52,Dine Out,Nottingham,Uk
1671,1672,12/04/2021,FPO,ANTIGONI ABRAHMS,5.0,,1038.32,Entertainment,London,Uk
1672,1673,12/04/2021,DEB,ECOTRICITY,500.0,,1043.32,Home Improvement,Nottingham,Uk
1673,1674,12/04/2021,DEB,AMZNMktplace,43.99,,1543.32,Amazon,Nottingham,Uk
1674,1675,09/04/2021,DEB,LIDL GB  NOTTINGHA,10.86,,1587.31,Groceries,Nottingham,Uk
1675,1676,09/04/2021,BP,SAVE THE CHANGE,0.01,,1598.17,Savings,Nottingham,Uk
1676,1677,08/04/2021,DEB,AMZNMktplace,6.0,,1598.18,Amazon,Nottingham,Uk
1677,1678,08/04/2021,DEB,AMZNMKTPLACE AMAZO,7.99,,1604.18,Amazon,Nottingham,Uk
1678,1679,08/04/2021,BP,SAVE THE CHANGE,0.2,,1612.17,Savings,Nottingham,Uk
1679,1680,07/04/2021,FPO,ALICJA ALEXANDER,25.0,,1612.37,Services/Home Improvement,Nottingham,Uk
1680,1681,07/04/2021,DEB,LIDL GB  NOTTINGHA,18.8,,1637.37,Groceries,Nottingham,Uk
1681,1682,07/04/2021,BP,SAVE THE CHANGE,0.08,,1656.17,Savings,Nottingham,Uk
1682,1683,06/04/2021,DEP,CLUB LLOYDS WAIVED,,3.0,1656.25,Amazon,Nottingham,Uk
1683,1684,06/04/2021,PAY,CLUB LLOYDS FEE,3.0,,1653.25,Bills,Nottingham,Uk
1684,1685,06/04/2021,DEB,AMZNMktplace,107.95,,1656.25,Supplementary Income,Nottingham,Uk
1685,1686,06/04/2021,DEB,AMZNMktplace,24.98,,1764.2,Amazon,Nottingham,Uk
1686,1687,06/04/2021,DEB,AMZNMktplace,19.99,,1789.18,Amazon,Nottingham,Uk
1687,1688,06/04/2021,FPO,TRADING212UK,500.0,,1809.17,Investment,Nottingham,Uk
1688,1689,06/04/2021,BP,SAVE THE CHANGE,3.44,,2309.17,Savings,Nottingham,Uk
1689,1690,06/04/2021,DEB,SOLO GRANO,5.7,,2312.61,Dine Out,Nottingham,Uk
1690,1691,06/04/2021,DEB,SOLO GRANO,3.36,,2318.31,Dine Out,Nottingham,Uk
1691,1692,06/04/2021,FPI,MIAH MA,,98.5,2321.67,Supplementary Income,Nottingham,Uk
1692,1693,06/04/2021,DEB,ORIENTAL MART HYDR,12.19,,2223.17,Groceries,Nottingham,Uk
1693,1694,06/04/2021,DEB,WWW.DOUGHN* DOUGHN,6.8,,2235.36,Dine Out,Nottingham,Uk
1694,1695,06/04/2021,DEB,WILKO RETAIL LIMIT,3.25,,2242.16,Other Shopping,,
1695,1696,06/04/2021,FPO,ANTIGONI ABRAHMS,5.0,,2245.41,Entertainment,London,Uk
1696,1697,06/04/2021,DEB,AMZNMktplace,16.99,,2250.41,Amazon,Nottingham,Uk
1697,1698,06/04/2021,DEB,LIDL GB  NOTTINGHA,16.74,,2267.4,Groceries,Nottingham,Uk
1698,1699,06/04/2021,DEB,AMZNMktplace,8.59,,2284.14,Amazon,Nottingham,Uk
1699,1700,06/04/2021,DEB,AMAZON.CO.UK*MU384,6.0,,2292.73,Amazon,Nottingham,Uk
1700,1701,06/04/2021,FPO,MR IAN ELLIS,140.0,,2298.73,Services,Nottingham,Uk
1701,1702,06/04/2021,DEB,AMZNMktplace,17.99,,2438.73,Amazon,Nottingham,Uk
1702,1703,01/04/2021,,INTEREST (GROSS),,0.48,2456.72,Interest,Nottingham,Uk
1703,1704,01/04/2021,DEB,AMZNMktplace,58.96,,2456.24,Amazon,Nottingham,Uk
1704,1705,01/04/2021,DEB,AMZNMktplace,8.99,,2515.2,Amazon,Nottingham,Uk
1705,1706,01/04/2021,DD,BARCLAYS UK MTGES,981.71,,2524.19,Bills,Nottingham,Uk
1706,1707,01/04/2021,SO,Q WANG,,1000.0,3505.9,Supplementary Income,Nottingham,Uk
1707,1708,01/04/2021,SO,ESAVINGS ACCOUNT,300.0,,2505.9,Savings,Nottingham,Uk
1708,1709,01/04/2021,BP,SAVE THE CHANGE,0.19,,2805.9,Savings,Nottingham,Uk
1709,1710,31/03/2021,DEB,AMZNMktplace,16.99,,2806.09,Amazon,Nottingham,Uk
1710,1711,31/03/2021,DEB,LIDL GB  NOTTINGHA,6.82,,2823.08,Groceries,Nottingham,Uk
1711,1712,31/03/2021,DEB,AMZ*hzmizimi,,16.99,2829.9,Supplementary Income,Nottingham,Uk
1712,1713,31/03/2021,BP,SAVE THE CHANGE,0.23,,2812.91,Savings,Nottingham,Uk
1713,1714,30/03/2021,DEB,SHARIF AND SONS SU,13.77,,2813.14,Groceries,Derby,Uk
1714,1715,30/03/2021,FPO,TRADING212UK,1000.0,,2826.91,Investment,Nottingham,Uk
1715,1716,30/03/2021,BP,SAVE THE CHANGE,0.95,,3826.91,Savings,Nottingham,Uk
1716,1717,30/03/2021,BGC,UNIV OF NOTTINGHAM,,3665.25,3827.86,Paycheck,Nottingham,Uk
1717,1718,29/03/2021,DEB,SOLO GRANO,8.05,,162.61,Dine Out,Nottingham,Uk
1718,1719,29/03/2021,BP,SAVE THE CHANGE,1.09,,170.66,Savings,Nottingham,Uk
1719,1720,29/03/2021,DEB,ORIENTAL MART HYDR,12.89,,171.75,Groceries,Nottingham,Uk
1720,1721,29/03/2021,DEB,WAITROSE 833,10.23,,184.64,,Nottingham,Uk
1721,1722,29/03/2021,DEB,WWW.DOUGHN* DOUGHN,6.8,,194.87,Dine Out,Nottingham,Uk
1722,1723,29/03/2021,FPO,ANTIGONI ABRAHMS,5.0,,201.67,Entertainment,London,Uk
1723,1724,29/03/2021,DEB,AMZNMktplace,16.99,,206.67,Amazon,Nottingham,Uk
1724,1725,26/03/2021,DD,TALKTALK LIMITED,19.95,,223.66,Bills,Nottingham,Uk
1725,1726,26/03/2021,BP,SAVE THE CHANGE,0.6,,243.61,Savings,Nottingham,Uk
1726,1727,25/03/2021,DEB,AMZNMktplace,16.99,,244.21,Amazon,Nottingham,Uk
1727,1728,25/03/2021,DEB,LIDL GB  NOTTINGHA,4.41,,261.2,Groceries,Nottingham,Uk
1728,1729,25/03/2021,FPO,TRADING212UK,200.0,,265.61,Investment,Nottingham,Uk
1729,1730,25/03/2021,FPI,YEWANDE MARIAN ADE,,400.0,465.61,Supplementary Income,Nottingham,Uk
1730,1731,25/03/2021,BP,SAVE THE CHANGE,0.02,,65.61,Savings,Nottingham,Uk
1731,1732,24/03/2021,DEB,IKEA LTD SHOP ONLI,320.0,,65.63,Other Shopping,,
1732,1733,24/03/2021,DEB,AMZNMKTPLACE AMAZO,74.99,,385.63,Amazon,Nottingham,Uk
1733,1734,24/03/2021,DEB,Audible UK,7.99,,460.62,Entertainment,Nottingham,Uk
1734,1735,24/03/2021,TFR,R LAWRENCE,,50.0,468.61,Supplementary Income,Nottingham,Uk
1735,1736,23/03/2021,DEB,LIDL GB  NOTTINGHA,11.1,,418.61,Groceries,Nottingham,Uk
1736,1737,23/03/2021,FPO,ALICJA ALEXANDER,25.0,,429.71,Services/Home Improvement,Nottingham,Uk
1737,1738,23/03/2021,BP,SAVE THE CHANGE,0.71,,454.71,Savings,Nottingham,Uk
1738,1739,22/03/2021,DEB,ORIENTAL MART HYDR,22.49,,455.42,Groceries,Nottingham,Uk
1739,1740,22/03/2021,DEB,WWW.DOUGHN* DOUGHN,6.8,,477.91,Dine Out,Nottingham,Uk
1740,1741,22/03/2021,DEB,UBER   *TRIP,2.0,,484.71,Travel,Nottingham,Uk
1741,1742,22/03/2021,BP,SAVE THE CHANGE,1.07,,486.71,Savings,Nottingham,Uk
1742,1743,22/03/2021,DEB,UBER *TRIP HELP.UB,13.66,,487.78,Travel,Nottingham,Uk
1743,1744,22/03/2021,FPO,ANTIGONI ABRAHMS,5.0,,501.44,Entertainment,London,Uk
1744,1745,22/03/2021,DEB,Audible UK,18.0,,506.44,Entertainment,Nottingham,Uk
1745,1746,22/03/2021,DEB,LIDL GB  NOTTINGHA,17.28,,524.44,Groceries,Nottingham,Uk
1746,1747,19/03/2021,FPO,TRADING212UK,100.0,,541.72,Investment,Nottingham,Uk
1747,1748,19/03/2021,DEB,AMZNMktplace,6.99,,641.72,Amazon,Nottingham,Uk
1748,1749,19/03/2021,BP,SAVE THE CHANGE,0.26,,648.71,Savings,Nottingham,Uk
1749,1750,18/03/2021,DEB,TESCO STORES 5368,3.74,,648.97,Groceries,,
1750,1751,18/03/2021,BP,SAVE THE CHANGE,0.5,,652.71,Savings,Nottingham,Uk
1751,1752,17/03/2021,DEB,LIDL GB  NOTTINGHA,5.87,,653.21,Groceries,Nottingham,Uk
1752,1753,17/03/2021,DEB,AMZNMktplace,3.63,,659.08,Amazon,Nottingham,Uk
1753,1754,17/03/2021,DD,VIRGIN MEDIA PYMTS,25.5,,662.71,Bills,Nottingham,Uk
1754,1755,17/03/2021,BP,SAVE THE CHANGE,0.8,,688.21,Savings,Nottingham,Uk
1755,1756,16/03/2021,DEB,AMZNMKTPLACE AMAZO,18.2,,689.01,Amazon,Nottingham,Uk
1756,1757,16/03/2021,DD,O2,16.44,,707.21,Other Shopping,Nottingham,Uk
1757,1758,16/03/2021,BP,SAVE THE CHANGE,1.35,,723.65,Savings,Nottingham,Uk
1758,1759,15/03/2021,DEB,SOLO GRANO,9.25,,725.0,Dine Out,Nottingham,Uk
1759,1760,15/03/2021,DEB,AMZNMKTPLACE AMAZO,6.4,,734.25,Amazon,Nottingham,Uk
1760,1761,15/03/2021,BP,SAVE THE CHANGE,1.7,,740.65,Savings,Nottingham,Uk
1761,1762,15/03/2021,DEB,ORIENTAL MART HYDR,13.02,,742.35,Groceries,Nottingham,Uk
1762,1763,15/03/2021,DEB,WWW.DOUGHNOTTSOFFI,6.8,,755.37,Dine Out,Nottingham,Uk
1763,1764,15/03/2021,DEB,HPI INSTANT INK UK,7.49,,762.17,Other Shopping,,
1764,1765,12/03/2021,DEB,Amazon.co.uk*MM61F,186.99,,769.66,Amazon,Nottingham,Uk
1765,1766,12/03/2021,BP,SAVE THE CHANGE,1.0,,956.65,Savings,Nottingham,Uk
1766,1767,11/03/2021,DEB,AMZNMktplace,5.14,,957.65,Amazon,Nottingham,Uk
1767,1768,11/03/2021,DEB,AMZNMKTPLACE AMAZO,42.86,,962.79,Amazon,Nottingham,Uk
1768,1769,10/03/2021,FPO,ALICJA ALEXANDER,25.0,,1005.65,Services/Home Improvement,Nottingham,Uk
1769,1770,10/03/2021,BP,SAVE THE CHANGE,0.84,,1030.65,Savings,Nottingham,Uk
1770,1771,09/03/2021,DEB,Amazon Prime*MM728,79.0,,1031.49,Amazon,Nottingham,Uk
1771,1772,09/03/2021,DEB,AMZNMktplace,19.92,,1110.49,Amazon,Nottingham,Uk
1772,1773,09/03/2021,DEB,LIDL GB  NOTTINGHA,10.24,,1130.41,Groceries,Nottingham,Uk
1773,1774,09/03/2021,BP,SAVE THE CHANGE,0.06,,1140.65,Savings,Nottingham,Uk
1774,1775,08/03/2021,DEB,ORIENTAL MART HYDR,13.94,,1140.71,Groceries,Nottingham,Uk
1775,1776,08/03/2021,FPO,KYLE MCDERMOTT,208.8,,1154.65,Services,Nottingham,Uk
1776,1777,08/03/2021,BP,SAVE THE CHANGE,1.53,,1363.45,Savings,Nottingham,Uk
1777,1778,08/03/2021,DEB,WWW.DOUGHNOTTSOFFI,6.8,,1364.98,Dine Out,Nottingham,Uk
1778,1779,08/03/2021,DEB,TESCO STORE 2960,2.0,,1371.78,Groceries,,
1779,1780,08/03/2021,FPO,ANTIGONI ABRAHMS,5.0,,1373.78,Entertainment,London,Uk
1780,1781,08/03/2021,DEB,Amazon.co.uk*MM82L,28.66,,1378.78,Amazon,Nottingham,Uk
1781,1782,05/03/2021,FPO,ROBERT RECORD,100.0,,1407.44,Others,Nottingham,Uk
1782,1783,05/03/2021,DEB,Amazon.co.uk*MM0OR,29.99,,1507.44,Amazon,Nottingham,Uk
1783,1784,05/03/2021,DEB,LIDL GB  NOTTINGHA,7.02,,1537.43,Groceries,Nottingham,Uk
1784,1785,04/03/2021,BP,SAVE THE CHANGE,0.75,,1544.45,Savings,Nottingham,Uk
1785,1786,03/03/2021,DEB,SAINSBURYS S/MKT,22.25,,1545.2,Groceries,,
1786,1787,03/03/2021,BP,SAVE THE CHANGE,1.27,,1567.45,Savings,Nottingham,Uk
1787,1788,02/03/2021,DEP,CLUB LLOYDS WAIVED,,3.0,1568.72,Supplementary Income,Nottingham,Uk
1788,1789,02/03/2021,PAY,CLUB LLOYDS FEE,3.0,,1565.72,Bills,Nottingham,Uk
1789,1790,02/03/2021,DEB,LIDL GB  NOTTINGHA,9.24,,1568.72,Groceries,Nottingham,Uk
1790,1791,02/03/2021,DEB,AMAZON.CO.UK*MM4J6,28.49,,1577.96,Amazon,Nottingham,Uk
1791,1792,02/03/2021,FPI,IISL CLIENT GBP SE,,17.77,1606.45,Supplementary Income,Nottingham,Uk
1792,1793,02/03/2021,FPI,IISL CLIENT GBP SE,,15.19,1588.68,Supplementary Income,Nottingham,Uk
1793,1794,02/03/2021,BP,SAVE THE CHANGE,0.45,,1573.49,Savings,Nottingham,Uk
1794,1795,01/03/2021,,INTEREST (GROSS),,0.57,1573.94,Interest,Nottingham,Uk
1795,1796,01/03/2021,DEB,TESCO STORES 6735,4.55,,1573.37,Groceries,,
1796,1797,01/03/2021,FPO,TRADING212UK,500.0,,1577.92,Investment,Nottingham,Uk
1797,1798,01/03/2021,DD,BARCLAYS UK MTGES,981.71,,2077.92,Bills,Nottingham,Uk
1798,1799,01/03/2021,SO,Q WANG,,1000.0,3059.63,Supplementary Income,Nottingham,Uk
1799,1800,01/03/2021,SO,ESAVINGS ACCOUNT,300.0,,2059.63,Savings,Nottingham,Uk
1800,1801,01/03/2021,BP,SAVE THE CHANGE,1.65,,2359.63,Savings,Nottingham,Uk
1801,1802,01/03/2021,DEB,ORIENTAL MART HYDR,14.31,,2361.28,Groceries,Nottingham,Uk
1802,1803,01/03/2021,DEB,WWW.DOUGHNOTTSOFFI,6.8,,2375.59,Dine Out,Nottingham,Uk
1803,1804,01/03/2021,FPO,ANTIGONI ABRAHMS,5.0,,2382.39,Entertainment,London,Uk
1804,1805,26/02/2021,DEB,CARPETRIGHT,497.48,,2387.39,Home Improvement,Nottingham,Uk
1805,1806,26/02/2021,DEB,AMZNMktplace,42.97,,2884.87,Amazon,Nottingham,Uk
1806,1807,26/02/2021,DEB,LIDL GB  NOTTINGHA,5.79,,2927.84,Groceries,Nottingham,Uk
1807,1808,26/02/2021,DD,TALKTALK LIMITED,19.95,,2933.63,Bills,Nottingham,Uk
1808,1809,26/02/2021,BP,SAVE THE CHANGE,0.65,,2953.58,Savings,Nottingham,Uk
1809,1810,25/02/2021,DEB,Trading212UK,201.4,,2954.23,Investment,Nottingham,Uk
1810,1811,25/02/2021,DEB,WILKO RETAIL LIMIT,13.95,,3155.63,Other Shopping,,
1811,1812,25/02/2021,FPO,TRADING212UK,1000.0,,3169.58,Investment,Nottingham,Uk
1812,1813,25/02/2021,BP,SAVE THE CHANGE,0.01,,4169.58,Savings,Nottingham,Uk
1813,1814,25/02/2021,BGC,UNIV OF NOTTINGHAM,,3665.25,4169.59,Paycheck,Nottingham,Uk
1814,1815,24/02/2021,DEB,CLASSIC DOORS AND,264.0,,504.34,Home Improvement,Nottingham,Uk
1815,1816,24/02/2021,DEB,Audible UK,7.99,,768.34,Entertainment,Nottingham,Uk
1816,1817,24/02/2021,BP,SAVE THE CHANGE,1.47,,776.33,Savings,Nottingham,Uk
1817,1818,23/02/2021,DEB,LIDL GB  NOTTINGHA,6.11,,777.8,Groceries,Nottingham,Uk
1818,1819,23/02/2021,DEB,LIDL GB  NOTTINGHA,4.42,,783.91,Groceries,Nottingham,Uk
1819,1820,23/02/2021,FPI,YEWANDE MARIAN ADE,,400.0,788.33,Supplementary Income,Nottingham,Uk
1820,1821,23/02/2021,TFR,R LAWRENCE,,100.0,388.33,Supplementary Income,Nottingham,Uk
1821,1822,23/02/2021,FPO,ALICJA ALEXANDER,25.0,,288.33,Services/Home Improvement,Nottingham,Uk
1822,1823,23/02/2021,BP,SAVE THE CHANGE,1.05,,313.33,Savings,Nottingham,Uk
1823,1824,22/02/2021,DEB,AMZNMktplace,15.9,,314.38,Amazon,Nottingham,Uk
1824,1825,22/02/2021,DEB,SOLO GRANO,9.05,,330.28,Dine Out,Nottingham,Uk
1825,1826,22/02/2021,BP,SAVE THE CHANGE,2.99,,339.33,Savings,Nottingham,Uk
1826,1827,22/02/2021,DEB,ORIENTAL MART HYDR,19.16,,342.32,Groceries,Nottingham,Uk
1827,1828,22/02/2021,DEB,WWW.DOUGHNOTTSOFFI,10.05,,361.48,Dine Out,Nottingham,Uk
1828,1829,22/02/2021,DEB,WWW.DOUGHNOTTSOFFI,3.55,,371.53,Dine Out,Nottingham,Uk
1829,1830,22/02/2021,DEB,PRET A MANGER,2.99,,375.08,Dine Out,,
1830,1831,22/02/2021,FPO,ANTIGONI ABRAHMS,5.0,,378.07,Entertainment,London,Uk
1831,1832,22/02/2021,DEB,LIDL GB  NOTTINGHA,8.26,,383.07,Groceries,Nottingham,Uk
1832,1833,19/02/2021,FPO,ANTONY GRICE (PLUM,93.6,,391.33,Home Improvement,Nottingham,Uk
1833,1834,19/02/2021,FPI,IISL CLIENT GBP SE,,43.51,484.93,Supplementary Income,Nottingham,Uk
1834,1835,18/02/2021,BP,SAVE THE CHANGE,0.77,,441.42,Savings,Nottingham,Uk
1835,1836,17/02/2021,DEB,SHARIF AND SONS SU,18.23,,442.19,Groceries,Derby,Uk
1836,1837,17/02/2021,DD,VIRGIN MEDIA PYMTS,25.5,,460.42,Bills,Nottingham,Uk
1837,1838,17/02/2021,BP,SAVE THE CHANGE,0.01,,485.92,Savings,Nottingham,Uk
1838,1839,16/02/2021,DEB,SHARIF AND SONS SU,40.99,,485.93,Groceries,Derby,Uk
1839,1840,16/02/2021,DD,O2,16.44,,526.92,Other Shopping,Nottingham,Uk
1840,1841,16/02/2021,BP,SAVE THE CHANGE,1.66,,543.36,Savings,Nottingham,Uk
1841,1842,15/02/2021,DEB,AMZNMktplace,23.69,,545.02,Amazon,Nottingham,Uk
1842,1843,15/02/2021,DEB,TESCO STORE 2960,5.5,,568.71,Groceries,,
1843,1844,15/02/2021,DEB,SOLO GRANO,3.15,,574.21,Dine Out,Nottingham,Uk
1844,1845,15/02/2021,BP,SAVE THE CHANGE,5.43,,577.36,Savings,Nottingham,Uk
1845,1846,15/02/2021,DEB,ORIENTAL MART HYDR,18.88,,582.79,Groceries,Nottingham,Uk
1846,1847,15/02/2021,DEB,WWW.DOUGHNOTTSOFFI,10.05,,601.67,Dine Out,Nottingham,Uk
1847,1848,15/02/2021,DEB,AMZNMKTPLACE AMAZO,3.21,,611.72,Amazon,Nottingham,Uk
1848,1849,15/02/2021,DEB,HPI INSTANT INK UK,6.49,,614.93,Other Shopping,,
1849,1850,15/02/2021,FPO,ANTIGONI ABRAHMS,5.0,,621.42,Entertainment,London,Uk
1850,1851,15/02/2021,DEB,Trading212UK,151.05,,626.42,Investment,Nottingham,Uk
1851,1852,15/02/2021,DEB,Trading212UK,151.05,,777.47,Investment,Nottingham,Uk
1852,1853,15/02/2021,DEB,CLASSIC DOORS AND,66.0,,928.52,Home Improvement,Nottingham,Uk
1853,1854,15/02/2021,DEB,V Spot,33.72,,994.52,Dine Out,Nottingham,Uk
1854,1855,12/02/2021,DEB,Amazon.co.uk*MF1LV,15.12,,1028.24,Amazon,Nottingham,Uk
1855,1856,12/02/2021,DEB,APOLLO BLINDS,415.0,,1043.36,Home Improvement,Nottingham,Uk
1856,1857,11/02/2021,DEB,ADI PRO LEAK LTD,594.0,,1458.36,Home Improvement,Nottingham,Uk
1857,1858,11/02/2021,FPI,S.H.S.,,240.0,2052.36,Supplementary Income,Nottingham,Uk
1858,1859,10/02/2021,TFR,R LAWRENCE,,500.0,1812.36,Supplementary Income,Nottingham,Uk
1859,1860,10/02/2021,BP,SAVE THE CHANGE,0.21,,1312.36,Savings,Nottingham,Uk
1860,1861,09/02/2021,FPO,ALICJA ALEXANDER,25.0,,1312.57,Services/Home Improvement,Nottingham,Uk
1861,1862,09/02/2021,DEB,LIDL GB  NOTTINGHA,7.79,,1337.57,Groceries,Nottingham,Uk
1862,1863,09/02/2021,BP,SAVE THE CHANGE,0.97,,1345.36,Savings,Nottingham,Uk
1863,1864,08/02/2021,DEB,LIDL GB  NOTTINGHA,12.03,,1346.33,Groceries,Nottingham,Uk
1864,1865,08/02/2021,BP,SAVE THE CHANGE,1.66,,1358.36,Savings,Nottingham,Uk
1865,1866,08/02/2021,DEB,ORIENTAL MART HYDR,24.49,,1360.02,Groceries,Nottingham,Uk
1866,1867,08/02/2021,DEB,AMZNMktplace,19.96,,1384.51,Amazon,Nottingham,Uk
1867,1868,08/02/2021,DEB,WWW.DOUGHNOTTSOFFI,10.05,,1404.47,Dine Out,Nottingham,Uk
1868,1869,08/02/2021,FPO,ANTIGONI ABRAHMS,5.0,,1414.52,Entertainment,London,Uk
1869,1870,05/02/2021,DEB,Trading212UK,553.85,,1419.52,Investment,Nottingham,Uk
1870,1871,05/02/2021,DEB,AMZNMktplace,11.99,,1973.37,Amazon,Nottingham,Uk
1871,1872,05/02/2021,FPI,IISL CLIENT GBP SE,,1.0,1985.36,Supplementary Income,Nottingham,Uk
1872,1873,04/02/2021,DEB,Trading212UK,,1.0,1984.36,Supplementary Income,Nottingham,Uk
1873,1874,04/02/2021,BP,SAVE THE CHANGE,0.87,,1983.36,Savings,Nottingham,Uk
1874,1875,03/02/2021,DEB,LIDL GB  NOTTINGHA,8.13,,1984.23,Groceries,Nottingham,Uk
1875,1876,03/02/2021,BP,SAVE THE CHANGE,0.5,,1992.36,Savings,Nottingham,Uk
1876,1877,02/02/2021,DEP,CLUB LLOYDS WAIVED,,3.0,1992.86,Supplementary Income,Nottingham,Uk
1877,1878,02/02/2021,PAY,CLUB LLOYDS FEE,3.0,,1989.86,Bills,Nottingham,Uk
1878,1879,02/02/2021,DEB,Trading212UK,503.5,,1992.86,Investment,Nottingham,Uk
1879,1880,01/02/2021,,INTEREST (GROSS),,0.56,2496.36,Interest,Nottingham,Uk
1880,1881,01/02/2021,FPO,SHS,240.0,,2495.8,Home Improvement,Nottingham,Uk
1881,1882,01/02/2021,TFR,R LAWRENCE,,128.0,2735.8,Supplementary Income,Nottingham,Uk
1882,1883,01/02/2021,DD,BARCLAYS UK MTGES,981.71,,2607.8,Bills,Nottingham,Uk
1883,1884,01/02/2021,SO,Q WANG,,1000.0,3589.51,Supplementary Income,Nottingham,Uk
1884,1885,01/02/2021,SO,ESAVINGS ACCOUNT,300.0,,2589.51,Savings,Nottingham,Uk
1885,1886,01/02/2021,BP,SAVE THE CHANGE,2.44,,2889.51,Savings,Nottingham,Uk
1886,1887,01/02/2021,DEB,ORIENTAL MART HYDR,18.71,,2891.95,Groceries,Nottingham,Uk
1887,1888,01/02/2021,DEB,WWW.DOUGHNOTTSOFFI,10.05,,2910.66,Dine Out,Nottingham,Uk
1888,1889,01/02/2021,DEB,LIDL GB  NOTTINGHA,4.8,,2920.71,Groceries,Nottingham,Uk
1889,1890,29/01/2021,DEB,Trading212UK,1001.4,,2925.51,Investment,Nottingham,Uk
1890,1891,29/01/2021,DEB,SAINSBURYS S/MKT,15.6,,3926.91,Groceries,,
1891,1892,29/01/2021,DD,TALKTALK LIMITED,19.95,,3942.51,Bills,Nottingham,Uk
1892,1893,28/01/2021,DEB,IKEA LTD SHOP ONLI,40.0,,3962.46,Other Shopping,,
1893,1894,28/01/2021,FPO,ALICJA ALEXANDER,25.0,,4002.46,Services/Home Improvement,Nottingham,Uk
1894,1895,28/01/2021,FPO,PATRICIA A S LAW,220.0,,4027.46,Other Shopping,,
1895,1896,28/01/2021,BP,SAVE THE CHANGE,1.13,,4247.46,Savings,Nottingham,Uk
1896,1897,28/01/2021,BGC,UNIV OF NOTTINGHAM,,3664.85,4248.59,Paycheck,Nottingham,Uk
1897,1898,27/01/2021,DEB,V Spot,23.87,,583.74,Dine Out,Nottingham,Uk
1898,1899,27/01/2021,DEB,WILKO RETAIL LIMIT,2.5,,607.61,Other Shopping,,
1899,1900,27/01/2021,DEB,CO-OP GROUP 010161,1.5,,610.11,Groceries,,
1900,1901,27/01/2021,BP,SAVE THE CHANGE,0.06,,611.61,Savings,Nottingham,Uk
1901,1902,26/01/2021,DEB,AMZNMktplace,47.95,,611.67,Amazon,Nottingham,Uk
1902,1903,26/01/2021,DEB,AMZNMktplace,13.99,,659.62,Amazon,Nottingham,Uk
1903,1904,26/01/2021,BP,SAVE THE CHANGE,0.35,,673.61,Savings,Nottingham,Uk
1904,1905,25/01/2021,FPO,ROBERT RECORD,75.0,,673.96,Others,Nottingham,Uk
1905,1906,25/01/2021,DEB,Trading212UK,200.0,,748.96,Investment,Nottingham,Uk
1906,1907,25/01/2021,DEB,TESCO STORES 5368,5.65,,948.96,Groceries,,
1907,1908,25/01/2021,BP,SAVE THE CHANGE,2.94,,954.61,Savings,Nottingham,Uk
1908,1909,25/01/2021,DEB,ORIENTAL MART HYDR,26.55,,957.55,Groceries,Nottingham,Uk
1909,1910,25/01/2021,DEB,Audible UK,7.99,,984.1,Entertainment,Nottingham,Uk
1910,1911,25/01/2021,DEB,WWW.DOUGHNOTTSOFFI,6.8,,992.09,Dine Out,Nottingham,Uk
1911,1912,25/01/2021,DEB,TESCO STORE 2960,5.11,,998.89,Groceries,,
1912,1913,25/01/2021,DEB,IKEA LTD SHOP ONLI,,65.0,1004.0,Supplementary Income,Nottingham,Uk
1913,1914,25/01/2021,FPI,YEWANDE MARIAN ADE,,400.0,939.0,Supplementary Income,Nottingham,Uk
1914,1915,25/01/2021,DEB,LIDL GB  NOTTINGHA,13.33,,539.0,Groceries,Nottingham,Uk
1915,1916,22/01/2021,DEB,IKEA LTD SHOP ONLI,65.0,,552.33,Other Shopping,,
1916,1917,22/01/2021,DEB,Amazon.co.uk*MV5U4,6.95,,617.33,Amazon,Nottingham,Uk
1917,1918,22/01/2021,DEB,Amazon.co.uk*MV7U0,5.33,,624.28,Amazon,Nottingham,Uk
1918,1919,22/01/2021,BP,SAVE THE CHANGE,1.18,,629.61,Savings,Nottingham,Uk
1919,1920,21/01/2021,DEB,AMZNMktplace,60.47,,630.79,Amazon,Nottingham,Uk
1920,1921,21/01/2021,DEB,AMAZON.CO.UK*MV8UG,4.6,,691.26,Amazon,Nottingham,Uk
1921,1922,21/01/2021,DEB,TESCO STORES 5368,2.75,,695.86,Groceries,,
1922,1923,21/01/2021,BP,SAVE THE CHANGE,0.55,,698.61,Savings,Nottingham,Uk
1923,1924,20/01/2021,DEB,TESCO STORES 5368,5.45,,699.16,Groceries,,
1924,1925,20/01/2021,BP,SAVE THE CHANGE,0.24,,704.61,Savings,Nottingham,Uk
1925,1926,19/01/2021,DEB,LIDL GB  NOTTINGHA,10.76,,704.85,Groceries,Nottingham,Uk
1926,1927,19/01/2021,BP,SAVE THE CHANGE,0.65,,715.61,Savings,Nottingham,Uk
1927,1928,18/01/2021,DEB,STARBUCKS,7.35,,716.26,Dine Out,,
1928,1929,18/01/2021,DD,VIRGIN MEDIA PYMTS,83.0,,723.61,Bills,Nottingham,Uk
1929,1930,18/01/2021,DD,O2,16.44,,806.61,Other Shopping,Nottingham,Uk
1930,1931,18/01/2021,BP,SAVE THE CHANGE,0.9,,823.05,Savings,Nottingham,Uk
1931,1932,18/01/2021,DEB,ORIENTAL MART HYDR,20.11,,823.95,Groceries,Nottingham,Uk
1932,1933,18/01/2021,DEB,AMZNMKTPLACE AMAZO,29.99,,844.06,Amazon,Nottingham,Uk
1933,1934,18/01/2021,FPO,ANTIGONI ABRAHMS,5.0,,874.05,Entertainment,London,Uk
1934,1935,15/01/2021,DEB,Trading212UK,200.0,,879.05,Investment,Nottingham,Uk
1935,1936,15/01/2021,BP,SAVE THE CHANGE,0.51,,1079.05,Savings,Nottingham,Uk
1936,1937,14/01/2021,DEB,HP INC UK LIMITED,3.49,,1079.56,Other Shopping,,
1937,1938,14/01/2021,DEB,AMAZON.CO.UK*MV3ZD,15.0,,1083.05,Amazon,Nottingham,Uk
1938,1939,14/01/2021,FPI,YEWANDE MARIAN ADE,,400.0,1098.05,Supplementary Income,Nottingham,Uk
1939,1940,14/01/2021,BP,SAVE THE CHANGE,0.27,,698.05,Savings,Nottingham,Uk
1940,1941,13/01/2021,DEB,LIDL GB  NOTTINGHA,18.73,,698.32,Groceries,Nottingham,Uk
1941,1942,12/01/2021,FPO,ALICJA ALEXANDER,25.0,,717.05,Services/Home Improvement,Nottingham,Uk
1942,1943,11/01/2021,BP,SAVE THE CHANGE,1.85,,742.05,Savings,Nottingham,Uk
1943,1944,11/01/2021,DEB,ORIENTAL MART HYDR,20.39,,743.9,Groceries,Nottingham,Uk
1944,1945,11/01/2021,DEB,LIDL GB  NOTTINGHA,9.12,,764.29,Groceries,Nottingham,Uk
1945,1946,11/01/2021,FPO,ANTIGONI ABRAHMS,5.0,,773.41,Entertainment,London,Uk
1946,1947,11/01/2021,DEB,Trading212UK,300.0,,778.41,Investment,Nottingham,Uk
1947,1948,11/01/2021,DEB,AMZNMktplace,19.99,,1078.41,Amazon,Nottingham,Uk
1948,1949,08/01/2021,DEB,AMAZON.CO.UK*MJ513,27.65,,1098.4,Amazon,Nottingham,Uk
1949,1950,08/01/2021,BP,SAVE THE CHANGE,0.5,,1126.05,Savings,Nottingham,Uk
1950,1951,07/01/2021,DEB,LIDL GB  NOTTINGHA,13.5,,1126.55,Groceries,Nottingham,Uk
1951,1952,06/01/2021,FPO,MR J LITCHFIELD,370.0,,1140.05,Services,Nottingham,Uk
1952,1953,06/01/2021,BP,SAVE THE CHANGE,0.49,,1510.05,Savings,Nottingham,Uk
1953,1954,05/01/2021,DEP,CLUB LLOYDS WAIVED,,3.0,1510.54,Supplementary Income,Nottingham,Uk
1954,1955,05/01/2021,PAY,CLUB LLOYDS FEE,3.0,,1507.54,Bills,Nottingham,Uk
1955,1956,05/01/2021,DEB,Trading212UK,500.0,,1510.54,Investment,Nottingham,Uk
1956,1957,05/01/2021,DEB,LIDL GB  NOTTINGHA,9.51,,2010.54,Groceries,Nottingham,Uk
1957,1958,04/01/2021,,INTEREST (GROSS),,1.87,2020.05,Interest,Swansea,Uk
1958,1959,04/01/2021,DD,BARCLAYS UK MTGES,981.71,,2018.18,Bills,Nottingham,Uk
1959,1960,04/01/2021,SO,Q WANG,,1000.0,2999.89,Supplementary Income,Nottingham,Uk
1960,1961,04/01/2021,SO,ESAVINGS ACCOUNT,300.0,,1999.89,Savings,Nottingham,Uk
1961,1962,04/01/2021,BP,SAVE THE CHANGE,0.15,,2299.89,Savings,Nottingham,Uk
1962,1963,04/01/2021,DEB,IKEA LTD SHOP ONLI,296.0,,2300.04,Other Shopping,,
1963,1964,31/12/2020,DEB,LIDL GB  NOTTINGHA,15.85,,2596.04,Groceries,Nottingham,Uk
1964,1965,31/12/2020,DD,TALKTALK LIMITED,18.64,,2611.89,Bills,Nottingham,Uk
1965,1966,31/12/2020,BP,SAVE THE CHANGE,0.67,,2630.53,Savings,Nottingham,Uk
1966,1967,30/12/2020,DEB,ORIENTAL MART HYDR,15.33,,2631.2,Groceries,Nottingham,Uk
1967,1968,30/12/2020,DEB,The Body Shop,15.0,,2646.53,Other Shopping,,
1968,1969,30/12/2020,BP,SAVE THE CHANGE,0.16,,2661.53,Savings,Nottingham,Uk
1969,1970,29/12/2020,FPO,SALLY GOLDSTONE,198.0,,2661.69,Others,Nottingham,Uk
1970,1971,29/12/2020,DEB,AMZNMktplace,27.84,,2859.69,Amazon,Nottingham,Uk
1971,1972,29/12/2020,BP,SAVE THE CHANGE,2.64,,2887.53,Savings,Nottingham,Uk
1972,1973,29/12/2020,DEB,T4 TEA SALOON,13.6,,2890.17,Dine Out,Nottingham,Uk
1973,1974,29/12/2020,DEB,TESCO STORES 5368,5.2,,2903.77,Groceries,,
1974,1975,29/12/2020,DEB,BLUEBIRD WHOLEFOOD,32.26,,2908.97,Groceries,Nottingham,Uk
1975,1976,24/12/2020,DEB,Trading212UK,250.0,,2941.23,Investment,Nottingham,Uk
1976,1977,24/12/2020,DEB,LIDL GB  NOTTINGHA,19.31,,3191.23,Groceries,Nottingham,Uk
1977,1978,24/12/2020,DEB,Audible UK,7.99,,3210.54,Entertainment,Nottingham,Uk
1978,1979,24/12/2020,BP,SAVE THE CHANGE,0.05,,3218.53,Savings,Nottingham,Uk
1979,1980,23/12/2020,DEB,Trading212UK,230.0,,3218.58,Investment,Nottingham,Uk
1980,1981,23/12/2020,DEB,AMZNMktplace,12.95,,3448.58,Amazon,Nottingham,Uk
1981,1982,23/12/2020,BP,SAVE THE CHANGE,0.48,,3461.53,Savings,Nottingham,Uk
1982,1983,22/12/2020,DEB,YANKEE STORE,9.72,,3462.01,Other Shopping,,
1983,1984,22/12/2020,DEB,CAFFE NERO 650 NOT,5.8,,3471.73,Dine Out,Nottingham,Uk
1984,1985,22/12/2020,FPO,SHS,240.0,,3477.53,Home Improvement,Nottingham,Uk
1985,1986,22/12/2020,FPO,MR J LITCHFIELD,682.0,,3717.53,Services,Nottingham,Uk
1986,1987,22/12/2020,DD,THE RENEWABLE ENER,92.93,,4399.53,Bills,Nottingham,Uk
1987,1988,22/12/2020,BP,SAVE THE CHANGE,0.31,,4492.46,Savings,Nottingham,Uk
1988,1989,21/12/2020,DEB,AMZNMktplace,8.69,,4492.77,Amazon,Nottingham,Uk
1989,1990,21/12/2020,FPO,ANTIGONI ABRAHMS,5.0,,4501.46,Entertainment,London,Uk
1990,1991,21/12/2020,BP,SAVE THE CHANGE,3.55,,4506.46,Savings,Nottingham,Uk
1991,1992,21/12/2020,DEB,ORIENTAL MART HYDR,17.27,,4510.01,Groceries,Nottingham,Uk
1992,1993,21/12/2020,DEB,PP*DOUGHNOTTS,6.5,,4527.28,Dine Out,Nottingham,Uk
1993,1994,21/12/2020,DEB,WILKO RETAIL LIMIT,1.0,,4533.78,Other Shopping,,
1994,1995,21/12/2020,DEB,Trading212UK,1000.0,,4534.78,Investment,Nottingham,Uk
1995,1996,21/12/2020,DEB,BLUEBIRD WHOLEFOOD,10.23,,5534.78,Groceries,Nottingham,Uk
1996,1997,21/12/2020,DEB,WILKO RETAIL LIMIT,10.0,,5545.01,Other Shopping,,
1997,1998,21/12/2020,DEB,OZAN INTERNATIONAL,5.35,,5555.01,Groceries,Nottingham,Uk
1998,1999,18/12/2020,DEB,AMZNMKTPLACE AMAZO,8.1,,5560.36,Amazon,Nottingham,Uk
1999,2000,18/12/2020,BP,SAVE THE CHANGE,0.93,,5568.46,Savings,Nottingham,Uk
2000,2001,18/12/2020,BGC,NCC TRADE CRED NEW,,32.44,5569.39,Supplementary Income,Nottingham,Uk
2001,2002,17/12/2020,DEB,AMZNMktplace,24.07,,5536.95,Amazon,Nottingham,Uk
2002,2003,17/12/2020,BP,SAVE THE CHANGE,0.04,,5561.02,Savings,Nottingham,Uk
2003,2004,17/12/2020,BGC,UNIV OF NOTTINGHAM,,3665.25,5561.06,Paycheck,Nottingham,Uk
2004,2005,16/12/2020,DEB,AMZNMktplace,29.99,,1895.81,Amazon,Nottingham,Uk
2005,2006,16/12/2020,DEB,AMZNMktplace,15.97,,1925.8,Amazon,Nottingham,Uk
2006,2007,16/12/2020,DD,BARCLAYS UK MTGES,1005.95,,1941.77,Bills,Nottingham,Uk
2007,2008,16/12/2020,DD,O2,16.44,,2947.72,Other Shopping,Nottingham,Uk
2008,2009,16/12/2020,BP,SAVE THE CHANGE,0.26,,2964.16,Savings,Nottingham,Uk
2009,2010,15/12/2020,DEB,Trading212UK,750.0,,2964.42,Investment,Nottingham,Uk
2010,2011,15/12/2020,DEB,LIDL GB  NOTTINGHA,8.94,,3714.42,Groceries,Nottingham,Uk
2011,2012,15/12/2020,DEB,CAFFE NERO 650 NOT,3.8,,3723.36,Dine Out,Nottingham,Uk
2012,2013,15/12/2020,BP,SAVE THE CHANGE,0.52,,3727.16,Savings,Nottingham,Uk
2013,2014,14/12/2020,DEB,AMZNMktplace,9.99,,3727.68,Amazon,Nottingham,Uk
2014,2015,14/12/2020,DEB,HP INC UK LIMITED,3.49,,3737.67,Other Shopping,,
2015,2016,14/12/2020,BP,SAVE THE CHANGE,3.38,,3741.16,Savings,Nottingham,Uk
2016,2017,14/12/2020,BGC,DEPOSIT PROTECTION,,950.0,3744.54,Supplementary Income,Nottingham,Uk
2017,2018,14/12/2020,BGC,SEVERN TRENT WATER,,17.6,2794.54,Supplementary Income,Nottingham,Uk
2018,2019,14/12/2020,DEB,AMZNMKTPLACE AMAZO,15.9,,2776.94,Amazon,Nottingham,Uk
2019,2020,14/12/2020,DEB,ORIENTAL MART HYDR,15.19,,2792.84,Groceries,Nottingham,Uk
2020,2021,14/12/2020,DEB,PP*DOUGHNOTTS,6.5,,2808.03,Dine Out,Nottingham,Uk
2021,2022,14/12/2020,DEB,STARBUCKS,3.95,,2814.53,Dine Out,,
2022,2023,14/12/2020,DEB,AMZNMktplace,40.29,,2818.48,Amazon,Nottingham,Uk
2023,2024,14/12/2020,DEB,LIDL GB  NOTTINGHA,12.29,,2858.77,Groceries,Nottingham,Uk
2024,2025,14/12/2020,DEB,AMZNMktplace,5.69,,2871.06,Amazon,Nottingham,Uk
2025,2026,14/12/2020,DEB,APOLLO BLINDS,200.0,,2876.75,Home Improvement,Nottingham,Uk
2026,2027,11/12/2020,DEB,AMZNMktplace,2.81,,3076.75,Amazon,Nottingham,Uk
2027,2028,11/12/2020,FPI,HOWELLS LEGAL LIMI,,276.0,3079.56,Supplementary Income,Nottingham,Uk
2028,2029,11/12/2020,BP,SAVE THE CHANGE,0.74,,2803.56,Savings,Nottingham,Uk
2029,2030,10/12/2020,FPO,ANTIGONI ABRAHMS,5.0,,2804.3,Entertainment,London,Uk
2030,2031,10/12/2020,FPO,ROBERT RECORD,310.0,,2809.3,Others,Nottingham,Uk
2031,2032,10/12/2020,DEB,Trading212UK,250.0,,3119.3,Investment,Nottingham,Uk
2032,2033,10/12/2020,DEB,SHARIF AND SONS SU,34.26,,3369.3,Groceries,Derby,Uk
2033,2034,10/12/2020,BP,SAVE THE CHANGE,0.19,,3403.56,Savings,Nottingham,Uk
2034,2035,09/12/2020,DEB,LIDL GB  NOTTINGHA,33.81,,3403.75,Groceries,Nottingham,Uk
2035,2036,09/12/2020,DEB,THE LITTLE CARPET,,246.0,3437.56,Home Improvement,Nottingham,Uk
2036,2037,09/12/2020,BP,SAVE THE CHANGE,1.16,,3191.56,Savings,Nottingham,Uk
2037,2038,08/12/2020,DEB,AMZNMktplace,62.77,,3192.72,Amazon,Nottingham,Uk
2038,2039,08/12/2020,DEB,AMZNMKTPLACE AMAZO,6.07,,3255.49,Amazon,Nottingham,Uk
2039,2040,07/12/2020,BP,SAVE THE CHANGE,0.98,,3261.56,Savings,Nottingham,Uk
2040,2041,07/12/2020,DEB,Trading212UK,200.0,,3262.54,Investment,Nottingham,Uk
2041,2042,07/12/2020,DEB,AMZNMktplace,23.98,,3462.54,Amazon,Nottingham,Uk
2042,2043,04/12/2020,DEB,BLUEBIRD WHOLEFOOD,14.04,,3486.52,Groceries,Nottingham,Uk
2043,2044,04/12/2020,BP,SAVE THE CHANGE,0.92,,3500.56,Savings,Nottingham,Uk
2044,2045,03/12/2020,DEB,JUBILEE SHOP,5.08,,3501.48,Others,Nottingham,Uk
2045,2046,03/12/2020,BP,SAVE THE CHANGE,0.93,,3506.56,Savings,Nottingham,Uk
2046,2047,02/12/2020,DEP,CLUB LLOYDS WAIVED,,3.0,3507.49,Supplementary Income,Nottingham,Uk
2047,2048,02/12/2020,PAY,CLUB LLOYDS FEE,3.0,,3504.49,Bills,Nottingham,Uk
2048,2049,02/12/2020,DEB,Trading212UK,500.0,,3507.49,Investment,Nottingham,Uk
2049,2050,02/12/2020,DEB,LIDL GB  NOTTINGHA,12.07,,4007.49,Groceries,Nottingham,Uk
2050,2051,01/12/2020,,INTEREST (GROSS),,1.48,4019.56,Interest,Nottingham,Uk
2051,2052,01/12/2020,FPI,Q WANG,,1000.0,4018.08,Supplementary Income,Nottingham,Uk
2052,2053,01/12/2020,DD,NOTTM CITY COUNC,119.0,,3018.08,Bills,Nottingham,Uk
2053,2054,01/12/2020,DD,SEVERN TRENT WATER,16.43,,3137.08,Bills,Nottingham,Uk
2054,2055,01/12/2020,SO,ESAVINGS ACCOUNT,300.0,,3153.51,Savings,Nottingham,Uk
2055,2056,01/12/2020,BP,SAVE THE CHANGE,0.87,,3453.51,Savings,Nottingham,Uk
2056,2057,30/11/2020,DEB,SOLO GRANO,9.13,,3454.38,Dine Out,Nottingham,Uk
2057,2058,30/11/2020,FPO,ALICJA ALEXANDER,40.0,,3463.51,Services/Home Improvement,Nottingham,Uk
2058,2059,30/11/2020,BP,SAVE THE CHANGE,0.78,,3503.51,Savings,Nottingham,Uk
2059,2060,30/11/2020,DEB,Trading212UK,1000.0,,3504.29,Investment,Nottingham,Uk
2060,2061,30/11/2020,DEB,THE BIKE SHOP,13.98,,4504.29,Other Shopping,,
2061,2062,30/11/2020,DEB,LIDL GB NOTTINGHAM,11.24,,4518.27,Groceries,Nottingham,Uk
2062,2063,30/11/2020,FPO,BORIS REMOVALS,650.0,,4529.51,Others,Nottingham,Uk
2063,2064,27/11/2020,DD,TALKTALK LIMITED,19.95,,5179.51,Bills,Nottingham,Uk
2064,2065,27/11/2020,BP,SAVE THE CHANGE,0.57,,5199.46,Savings,Nottingham,Uk
2065,2066,27/11/2020,BGC,UNIV OF NOTTINGHAM,,3665.25,5200.03,Paycheck,Nottingham,Uk
2066,2067,26/11/2020,DEB,JUBILEE SHOP,6.43,,1534.78,Others,Nottingham,Uk
2067,2068,26/11/2020,BP,SAVE THE CHANGE,1.98,,1541.21,Savings,Nottingham,Uk
2068,2069,25/11/2020,DEB,Trading212UK,1405.0,,1543.19,Investment,Nottingham,Uk
2069,2070,25/11/2020,DEB,AMZNMktplace,47.89,,2948.19,Amazon,Nottingham,Uk
2070,2071,25/11/2020,DEB,Trading212UK,25.0,,2996.08,Investment,Nottingham,Uk
2071,2072,25/11/2020,DEB,MOGAL EXPRESS,18.06,,3021.08,Groceries,Nottingham,Uk
2072,2073,25/11/2020,DEB,LIDL GB NOTTINGHAM,7.07,,3039.14,Groceries,Nottingham,Uk
2073,2074,25/11/2020,BP,SAVE THE CHANGE,0.03,,3046.21,Savings,Nottingham,Uk
2074,2075,25/11/2020,BGC,GOOGLE IRELAND,,61.65,3046.24,Supplementary Income,Nottingham,Uk
2075,2076,24/11/2020,DEB,AMZNMktplace,19.98,,2984.59,Amazon,Nottingham,Uk
2076,2077,24/11/2020,DEB,Audible UK,7.99,,3004.57,Entertainment,Nottingham,Uk
2077,2078,24/11/2020,FPI,IISL CLIENT GBP SE,,1405.69,3012.56,Supplementary Income,Nottingham,Uk
2078,2079,23/11/2020,BP,SAVE THE CHANGE,2.49,,1606.87,Savings,Nottingham,Uk
2079,2080,23/11/2020,DEB,ORIENTAL MART HYDR,10.52,,1609.36,Groceries,Nottingham,Uk
2080,2081,23/11/2020,DEB,STARBUCKS,7.4,,1619.88,Dine Out,,
2081,2082,23/11/2020,DEB,LIDL GB NOTTINGHAM,6.42,,1627.28,Groceries,Nottingham,Uk
2082,2083,23/11/2020,DEB,PP*DOUGHNOTTS,5.5,,1633.7,Dine Out,Nottingham,Uk
2083,2084,23/11/2020,DEB,Trading212UK,738.0,,1639.2,Investment,Nottingham,Uk
2084,2085,23/11/2020,DEB,CO-OP GROUP 010661,11.78,,2377.2,Groceries,,
2085,2086,23/11/2020,DEB,Amazon.co.uk*M703H,6.0,,2388.98,Amazon,Nottingham,Uk
2086,2087,23/11/2020,DEB,AMZNMKTPLACE AMAZO,45.89,,2394.98,Amazon,Nottingham,Uk
2087,2088,20/11/2020,DEB,Trading212UK,106.0,,2440.87,Investment,Nottingham,Uk
2088,2089,20/11/2020,FPI,IISL CLIENT GBP SE,,737.35,2546.87,Supplementary Income,Nottingham,Uk
2089,2090,20/11/2020,BP,SAVE THE CHANGE,0.76,,1809.52,Savings,Nottingham,Uk
2090,2091,19/11/2020,DEB,THE LITTLE CARPET,1174.0,,1810.28,Home Improvement,Nottingham,Uk
2091,2092,19/11/2020,DEB,AMZNMktplace,11.49,,2984.28,Amazon,Nottingham,Uk
2092,2093,19/11/2020,DEB,AMAZON.CO.UK*M75IR,6.0,,2995.77,Amazon,Nottingham,Uk
2093,2094,19/11/2020,DEB,ATRIUM JUBILEE 1,3.75,,3001.77,Dine Out,Nottingham,Uk
2094,2095,19/11/2020,FPI,IISL CLIENT GBP SE,,105.82,3005.52,Supplementary Income,Nottingham,Uk
2095,2096,19/11/2020,BP,SAVE THE CHANGE,1.35,,2899.7,Savings,Nottingham,Uk
2096,2097,18/11/2020,DEB,AMZNMktplace,31.98,,2901.05,Amazon,Nottingham,Uk
2097,2098,18/11/2020,DEB,AMZNMktplace,21.09,,2933.03,Amazon,Nottingham,Uk
2098,2099,18/11/2020,DEB,LIDL GB NOTTINGHAM,7.58,,2954.12,Groceries,Nottingham,Uk
2099,2100,18/11/2020,FPO,ALICJA ALEXANDER,25.0,,2961.7,Services/Home Improvement,Nottingham,Uk
2100,2101,17/11/2020,DEB,Trading212UK,860.0,,2986.7,Investment,Nottingham,Uk
2101,2102,17/11/2020,BP,SAVE THE CHANGE,1.06,,3846.7,Savings,Nottingham,Uk
2102,2103,16/11/2020,DEB,LIDL GB NOTTINGHAM,13.49,,3847.76,Groceries,Nottingham,Uk
2103,2104,16/11/2020,DEB,AMAZON.CO.UK*M7959,10.45,,3861.25,Amazon,Nottingham,Uk
2104,2105,16/11/2020,FPI,IISL CLIENT GBP SE,,100.0,3871.7,Supplementary Income,Nottingham,Uk
2105,2106,16/11/2020,FPI,IISL CLIENT GBP SE,,760.39,3771.7,Supplementary Income,Nottingham,Uk
2106,2107,16/11/2020,DD,O2,16.63,,3011.31,Other Shopping,Nottingham,Uk
2107,2108,16/11/2020,BP,SAVE THE CHANGE,2.85,,3027.94,Savings,Nottingham,Uk
2108,2109,16/11/2020,DEB,ORIENTAL MART HYDR,15.24,,3030.79,Groceries,Nottingham,Uk
2109,2110,16/11/2020,DEB,AMZNMktplace,13.73,,3046.03,Amazon,Nottingham,Uk
2110,2111,16/11/2020,DEB,HOLLAND & BARRETT,9.49,,3059.76,Groceries,,
2111,2112,16/11/2020,DEB,ORIENTAL MART HYDR,0.79,,3069.25,Groceries,Nottingham,Uk
2112,2113,16/11/2020,DEB,Trading212UK,1333.0,,3070.04,Investment,Nottingham,Uk
2113,2114,16/11/2020,DEB,Trading212UK,100.0,,4403.04,Investment,Nottingham,Uk
2114,2115,16/11/2020,CPT,LNK 36 CLUMBER STR,40.0,,4503.04,Cash,Nottingham,Uk
2115,2116,13/11/2020,DEB,POST OFFICE COUNTE,47.99,,4543.04,Others,Nottingham,Uk
2116,2117,13/11/2020,DEB,AMZNMktplace,11.49,,4591.03,Amazon,Nottingham,Uk
2117,2118,13/11/2020,DEB,Amazon.co.uk*M768X,3.42,,4602.52,Amazon,Nottingham,Uk
2118,2119,13/11/2020,FPI,IISL CLIENT GBP SE,,1333.06,4605.94,Supplementary Income,Nottingham,Uk
2119,2120,13/11/2020,BP,SAVE THE CHANGE,0.03,,3272.88,Savings,Nottingham,Uk
2120,2121,12/11/2020,DEB,AMZNMktplace,16.97,,3272.91,Amazon,Nottingham,Uk
2121,2122,11/11/2020,FPI,ALHARBI M,,1000.0,3289.88,Supplementary Income,Nottingham,Uk
2122,2123,11/11/2020,BP,SAVE THE CHANGE,0.35,,2289.88,Savings,Nottingham,Uk
2123,2124,10/11/2020,DEB,LIDL GB NOTTINGHAM,33.65,,2290.23,Groceries,Nottingham,Uk
2124,2125,10/11/2020,BP,SAVE THE CHANGE,0.87,,2323.88,Savings,Nottingham,Uk
2125,2126,09/11/2020,DEB,Amazon.co.uk*M73C5,3.64,,2324.75,Amazon,Nottingham,Uk
2126,2127,09/11/2020,DEB,HOLLAND & BARRETT,5.49,,2328.39,Groceries,,
2127,2128,09/11/2020,FPO,TRISTRAMS LETTINGS,825.0,,2333.88,Home Improvement,Nottingham,Uk
2128,2129,09/11/2020,BP,SAVE THE CHANGE,1.96,,3158.88,Savings,Nottingham,Uk
2129,2130,09/11/2020,DEB,ORIENTAL MART HYDR,14.74,,3160.84,Groceries,Nottingham,Uk
2130,2131,09/11/2020,DEB,LIDL GB NOTTINGHAM,11.07,,3175.58,Groceries,Nottingham,Uk
2131,2132,09/11/2020,DEB,STARBUCKS,3.95,,3186.65,Dine Out,,
2132,2133,09/11/2020,DEB,POUNDSTRETCHER 63,2.28,,3190.6,Groceries,,
2133,2134,09/11/2020,DEB,Trading212UK,1328.0,,3192.88,Investment,Nottingham,Uk
2134,2135,09/11/2020,DEB,Amazon.co.uk*M78CB,16.0,,4520.88,Amazon,Nottingham,Uk
2135,2136,06/11/2020,DEB,Audible UK,18.0,,4536.88,Entertainment,Nottingham,Uk
2136,2137,06/11/2020,DEB,AMAZON.CO.UK*M74IF,15.0,,4554.88,Amazon,Nottingham,Uk
2137,2138,06/11/2020,FPI,IISL CLIENT GBP SE,,1328.0,4569.88,Supplementary Income,Nottingham,Uk
2138,2139,06/11/2020,BP,SAVE THE CHANGE,0.5,,3241.88,Savings,Nottingham,Uk
2139,2140,05/11/2020,DEB,CO-OP GROUP 010661,9.5,,3242.38,Groceries,,
2140,2141,05/11/2020,BP,SAVE THE CHANGE,0.46,,3251.88,Savings,Nottingham,Uk
2141,2142,04/11/2020,FPO,ALICJA ALEXANDER,25.0,,3252.34,Services/Home Improvement,Nottingham,Uk
2142,2143,04/11/2020,DEB,AMZNMktplace,19.54,,3277.34,Amazon,Nottingham,Uk
2143,2144,04/11/2020,DEB,Trading212UK,1.0,,3296.88,Investment,Nottingham,Uk
2144,2145,04/11/2020,BP,SAVE THE CHANGE,0.82,,3297.88,Savings,Nottingham,Uk
2145,2146,03/11/2020,DEP,CLUB LLOYDS WAIVED,,3.0,3298.7,Supplementary Income,Nottingham,Uk
2146,2147,03/11/2020,FPO,TAMBA TAM,10.0,,3295.7,Services,Nottingham,Uk
2147,2148,03/11/2020,PAY,CLUB LLOYDS FEE,3.0,,3305.7,Bills,Nottingham,Uk
2148,2149,03/11/2020,DEB,LIDL GB NOTTINGHAM,14.18,,3308.7,Groceries,Nottingham,Uk
2149,2150,03/11/2020,SO,TRISTRAMS LETTINGS,825.0,,3322.88,Home Improvement,Nottingham,Uk
2150,2151,03/11/2020,BP,SAVE THE CHANGE,0.58,,4147.88,Savings,Nottingham,Uk
2151,2152,02/11/2020,,INTEREST (GROSS),,1.71,4148.46,Interest,Nottingham,Uk
2152,2153,02/11/2020,DEB,CO-OP GROUP 010661,4.92,,4146.75,Groceries,,
2153,2154,02/11/2020,DEB,PP*DOUGHNOTTS,5.5,,4151.67,Dine Out,Nottingham,Uk
2154,2155,02/11/2020,DD,NOTTM CITY COUNC,119.0,,4157.17,Bills,Nottingham,Uk
2155,2156,02/11/2020,DD,SEVERN TRENT WATER,25.7,,4276.17,Bills,Nottingham,Uk
2156,2157,02/11/2020,SO,ESAVINGS ACCOUNT,300.0,,4301.87,Savings,Nottingham,Uk
2157,2158,02/11/2020,BP,SAVE THE CHANGE,0.29,,4601.87,Savings,Nottingham,Uk
2158,2159,02/11/2020,DEB,ORIENTAL MART HYDR,14.72,,4602.16,Groceries,Nottingham,Uk
2159,2160,02/11/2020,DEB,T K MAXX,8.99,,4616.88,Other Shopping,,
2160,2161,02/11/2020,DEB,CO-OP GROUP 010661,4.0,,4625.87,Groceries,,
2161,2162,30/10/2020,DEB,Trading212UK,1100.0,,4629.87,Investment,Nottingham,Uk
2162,2163,30/10/2020,DEB,DANCE IN TIME BOUT,5.0,,5729.87,Clothes,,
2163,2164,30/10/2020,BP,SAVE THE CHANGE,1.36,,5734.87,Savings,Nottingham,Uk
2164,2165,29/10/2020,DEB,Trading212UK,1756.0,,5736.23,Investment,Nottingham,Uk
2165,2166,29/10/2020,DEB,LIDL GB NOTTINGHAM,17.14,,7492.23,Groceries,Nottingham,Uk
2166,2167,29/10/2020,DEB,IZ *Secret Burger,8.5,,7509.37,Dine Out,Nottingham,Uk
2167,2168,29/10/2020,FPO,LAURA FOGLIATA,7.0,,7517.87,Services,Nottingham,Uk
2168,2169,29/10/2020,DD,THE RENEWABLE ENER,100.65,,7524.87,Bills,Nottingham,Uk
2169,2170,29/10/2020,BP,SAVE THE CHANGE,0.9,,7625.52,Savings,Nottingham,Uk
2170,2171,29/10/2020,BGC,UNIV OF NOTTINGHAM,,3664.85,7626.42,Paycheck,Nottingham,Uk
2171,2172,28/10/2020,DEB,AMZNMktplace,15.1,,3961.57,Amazon,Nottingham,Uk
2172,2173,28/10/2020,FPI,IISL CLIENT GBP SE,,1756.0,3976.67,Supplementary Income,Nottingham,Uk
2173,2174,27/10/2020,DD,TALKTALK LIMITED,19.95,,2220.67,Bills,Nottingham,Uk
2174,2175,27/10/2020,BP,SAVE THE CHANGE,0.45,,2240.62,Savings,Nottingham,Uk
2175,2176,26/10/2020,DEB,STARBUCKS,3.55,,2241.07,Dine Out,,
2176,2177,26/10/2020,BP,SAVE THE CHANGE,2.15,,2244.62,Savings,Nottingham,Uk
2177,2178,26/10/2020,DEB,ORIENTAL MART HYDR,13.28,,2246.77,Groceries,Nottingham,Uk
2178,2179,26/10/2020,DEB,PP*DOUGHNOTTS,5.5,,2260.05,Dine Out,Nottingham,Uk
2179,2180,26/10/2020,DEB,Audible UK,7.99,,2265.55,Entertainment,Nottingham,Uk
2180,2181,26/10/2020,DEB,JUBILEE SHOP,5.08,,2273.54,Others,Nottingham,Uk
2181,2182,23/10/2020,DEB,Trading212UK,1326.0,,2278.62,Investment,Nottingham,Uk
2182,2183,23/10/2020,DEB,Amazon.co.uk*XB9UV,15.0,,3604.62,Amazon,Nottingham,Uk
2183,2184,23/10/2020,BP,SAVE THE CHANGE,0.14,,3619.62,Savings,Nottingham,Uk
2184,2185,22/10/2020,DEB,LIDL GB NOTTINGHAM,12.86,,3619.76,Groceries,Nottingham,Uk
2185,2186,22/10/2020,FPO,LAURA FOGLIATA,7.0,,3632.62,Services,Nottingham,Uk
2186,2187,22/10/2020,FPO,ALICJA ALEXANDER,25.0,,3639.62,Services/Home Improvement,Nottingham,Uk
2187,2188,22/10/2020,FPI,IISL CLIENT GBP SE,,1326.0,3664.62,Supplementary Income,Nottingham,Uk
2188,2189,22/10/2020,BP,SAVE THE CHANGE,0.51,,2338.62,Savings,Nottingham,Uk
2189,2190,21/10/2020,DEB,Amazon.co.uk*840ZD,3.49,,2339.13,Amazon,Nottingham,Uk
2190,2191,21/10/2020,BP,SAVE THE CHANGE,0.72,,2342.62,Savings,Nottingham,Uk
2191,2192,20/10/2020,DEB,CO-OP GROUP 010661,10.29,,2343.34,Groceries,,
2192,2193,20/10/2020,DEB,AMZNMKTPLACE AMAZO,5.99,,2353.63,Amazon,Nottingham,Uk
2193,2194,20/10/2020,BP,SAVE THE CHANGE,0.53,,2359.62,Savings,Nottingham,Uk
2194,2195,19/10/2020,DEB,T K MAXX,11.97,,2360.15,Other Shopping,,
2195,2196,19/10/2020,DEB,PP*DOUGHNOTTS,6.5,,2372.12,Dine Out,Nottingham,Uk
2196,2197,19/10/2020,BP,SAVE THE CHANGE,2.89,,2378.62,Savings,Nottingham,Uk
2197,2198,19/10/2020,DEB,Amazon.co.uk*EZ8KJ,16.0,,2381.51,Amazon,Nottingham,Uk
2198,2199,19/10/2020,DEB,SOLO GRANO,13.31,,2397.51,Dine Out,Nottingham,Uk
2199,2200,19/10/2020,DEB,ORIENTAL MART HYDR,10.38,,2410.82,Groceries,Nottingham,Uk
2200,2201,19/10/2020,DEB,JUBILEE SHOP,5.08,,2421.2,Others,Nottingham,Uk
2201,2202,19/10/2020,DEB,STARBUCKS,3.35,,2426.28,Dine Out,,
2202,2203,16/10/2020,DEB,Trading212UK,926.0,,2429.63,Investment,Nottingham,Uk
2203,2204,16/10/2020,DEB,Trading212UK,75.0,,3355.63,Investment,Nottingham,Uk
2204,2205,16/10/2020,DEB,AMZNMktplace,33.99,,3430.63,Amazon,Nottingham,Uk
2205,2206,16/10/2020,DD,O2,17.18,,3464.62,Other Shopping,Nottingham,Uk
2206,2207,16/10/2020,BP,SAVE THE CHANGE,1.7,,3481.8,Savings,Nottingham,Uk
2207,2208,15/10/2020,FPO,LAURA FOGLIATA,3.0,,3483.5,Services,Nottingham,Uk
2208,2209,15/10/2020,FPO,LAURA FOGLIATA,7.0,,3486.5,Services,Nottingham,Uk
2209,2210,15/10/2020,DEB,LIDL GB NOTTINGHAM,21.11,,3493.5,Groceries,Nottingham,Uk
2210,2211,15/10/2020,DEB,JUBILEE SHOP,6.19,,3514.61,Others,Nottingham,Uk
2211,2212,15/10/2020,FPI,IISL CLIENT GBP SE,,926.0,3520.8,Supplementary Income,Nottingham,Uk
2212,2213,15/10/2020,BP,SAVE THE CHANGE,0.01,,2594.8,Savings,Nottingham,Uk
2213,2214,14/10/2020,DEB,AMZNMktplace,3.99,,2594.81,Amazon,Nottingham,Uk
2214,2215,14/10/2020,BP,SAVE THE CHANGE,0.01,,2598.8,Savings,Nottingham,Uk
2215,2216,13/10/2020,FPO,TAMBA TAM,20.0,,2598.81,Services,Nottingham,Uk
2216,2217,13/10/2020,DEB,AMZNMktplace,79.99,,2618.81,Amazon,Nottingham,Uk
2217,2218,13/10/2020,BP,SAVE THE CHANGE,1.8,,2698.8,Savings,Nottingham,Uk
2218,2219,12/10/2020,DEB,PP*DOUGHNOTTS,4.5,,2700.6,Dine Out,Nottingham,Uk
2219,2220,12/10/2020,DEB,CAFFE NERO NOTTING,3.3,,2705.1,Dine Out,Nottingham,Uk
2220,2221,12/10/2020,DEB,WILKO RETAIL LIMIT,2.4,,2708.4,Other Shopping,,
2221,2222,12/10/2020,BP,SAVE THE CHANGE,0.96,,2710.8,Savings,Nottingham,Uk
2222,2223,12/10/2020,DEB,ORIENTAL MART HYDR,16.7,,2711.76,Groceries,Nottingham,Uk
2223,2224,12/10/2020,DEB,STARBUCKS,3.35,,2728.46,Dine Out,,
2224,2225,12/10/2020,DEB,AMZNMKTPLACE AMAZO,11.99,,2731.81,Amazon,Nottingham,Uk
2225,2226,09/10/2020,BP,SAVE THE CHANGE,0.32,,2743.8,Savings,Nottingham,Uk
2226,2227,08/10/2020,FPO,ALICJA ALEXANDER,25.0,,2744.12,Services/Home Improvement,Nottingham,Uk
2227,2228,08/10/2020,FPO,LAURA FOGLIATA,7.0,,2769.12,Services,Nottingham,Uk
2228,2229,08/10/2020,DEB,LIDL GB NOTTINGHAM,17.68,,2776.12,Groceries,Nottingham,Uk
2229,2230,07/10/2020,DEB,Trading212UK,866.0,,2793.8,Investment,Nottingham,Uk
2230,2231,06/10/2020,FPO,TAMBA TAM,10.0,,3659.8,Services,Nottingham,Uk
2231,2232,06/10/2020,TFR,R LAWRENCE,200.0,,3669.8,,,
2232,2233,06/10/2020,FPI,IISL CLIENT GBP SE,,866.0,3869.8,Supplementary Income,Nottingham,Uk
2233,2234,06/10/2020,BP,SAVE THE CHANGE,0.3,,3003.8,Savings,Nottingham,Uk
2234,2235,05/10/2020,DEB,AMZNMktplace,7.99,,3004.1,Amazon,Nottingham,Uk
2235,2236,05/10/2020,DEB,CO-OP GROUP 010661,4.71,,3012.09,Groceries,,
2236,2237,05/10/2020,SO,TRISTRAMS LETTINGS,825.0,,3016.8,Home Improvement,Nottingham,Uk
2237,2238,05/10/2020,BP,SAVE THE CHANGE,1.09,,3841.8,Savings,Nottingham,Uk
2238,2239,05/10/2020,DEB,MOGAL EXPRESS,11.77,,3842.89,Groceries,Nottingham,Uk
2239,2240,05/10/2020,DEB,ORIENTAL MART HYDR,7.96,,3854.66,Groceries,Nottingham,Uk
2240,2241,05/10/2020,DEB,ONEBELOW,3.0,,3862.62,Other Shopping,,
2241,2242,05/10/2020,CPT,LNK 49-51 CLUMBER,40.0,,3865.62,Cash,Nottingham,Uk
2242,2243,02/10/2020,DEP,CLUB LLOYDS WAIVED,,3.0,3905.62,Amazon,Nottingham,Uk
2243,2244,02/10/2020,PAY,CLUB LLOYDS FEE,3.0,,3902.62,Bills,Nottingham,Uk
2244,2245,02/10/2020,DEB,AMZNMktplace,46.18,,3905.62,Supplementary Income,Nottingham,Uk
2245,2246,02/10/2020,BP,SAVE THE CHANGE,0.23,,3951.8,Savings,Nottingham,Uk
2246,2247,01/10/2020,,INTEREST (GROSS),,2.39,3952.03,Interest,Nottingham,Uk
2247,2248,01/10/2020,FPO,LAURA FOGLIATA,7.0,,3949.64,Services,Nottingham,Uk
2248,2249,01/10/2020,DEB,LIDL GB NOTTINGHAM,26.77,,3956.64,Groceries,Nottingham,Uk
2249,2250,01/10/2020,DD,NOTTM CITY COUNC,119.0,,3983.41,Bills,Nottingham,Uk
2250,2251,01/10/2020,DD,SEVERN TRENT WATER,25.7,,4102.41,Bills,Nottingham,Uk
2251,2252,01/10/2020,SO,ESAVINGS ACCOUNT,300.0,,4128.11,Savings,Nottingham,Uk
2252,2253,01/10/2020,BP,SAVE THE CHANGE,0.2,,4428.11,Savings,Nottingham,Uk
2253,2254,30/09/2020,DEB,Trading212UK,1000.0,,4428.31,Investment,Nottingham,Uk
2254,2255,30/09/2020,DEB,AMZNMktplace,2.8,,5428.31,Amazon,Nottingham,Uk
2255,2256,30/09/2020,DD,TALKTALK LIMITED,19.95,,5431.11,Bills,Nottingham,Uk
2256,2257,30/09/2020,BP,SAVE THE CHANGE,0.32,,5451.06,Savings,Nottingham,Uk
2257,2258,29/09/2020,DEB,AMAZON.CO.UK*JX79R,5.68,,5451.38,Amazon,Nottingham,Uk
2258,2259,29/09/2020,FPO,TAMBA TAM,10.0,,5457.06,Services,Nottingham,Uk
2259,2260,29/09/2020,DD,THE RENEWABLE ENER,74.3,,5467.06,Bills,Nottingham,Uk
2260,2261,29/09/2020,BP,SAVE THE CHANGE,1.53,,5541.36,Savings,Nottingham,Uk
2261,2262,29/09/2020,BGC,UNIV OF NOTTINGHAM,,3665.25,5542.89,Paycheck,Nottingham,Uk
2262,2263,28/09/2020,DEB,GHOUSIA FOODS,13.28,,1877.64,Groceries,Nottingham,Uk
2263,2264,28/09/2020,DEB,CO-OP GROUP 010661,5.19,,1890.92,Groceries,,
2264,2265,28/09/2020,BP,SAVE THE CHANGE,0.21,,1896.11,Savings,Nottingham,Uk
2265,2266,28/09/2020,DEB,Amazon.co.uk*KS7R7,6.0,,1896.32,Amazon,Nottingham,Uk
2266,2267,28/09/2020,DEB,THE ORGAN GRINDER,1.8,,1902.32,Dine Out,Nottingham,Uk
2267,2268,25/09/2020,DEB,AMZNMktplace,14.99,,1904.12,Amazon,Nottingham,Uk
2268,2269,25/09/2020,DEB,CO-OP GROUP 010661,7.0,,1919.11,Groceries,,
2269,2270,25/09/2020,DEB,NBX*AT1.SPACE,175.0,,1926.11,Fitness,Nottingham,Uk
2270,2271,25/09/2020,BP,SAVE THE CHANGE,0.86,,2101.11,Savings,Nottingham,Uk
2271,2272,24/09/2020,FPO,LAURA FOGLIATA,7.0,,2101.97,Services,Nottingham,Uk
2272,2273,24/09/2020,DEB,LIDL GB NOTTINGHAM,12.15,,2108.97,Groceries,Nottingham,Uk
2273,2274,24/09/2020,DEB,Audible UK,7.99,,2121.12,Entertainment,Nottingham,Uk
2274,2275,24/09/2020,FPO,ALICJA ALEXANDER,25.0,,2129.11,Services/Home Improvement,Nottingham,Uk
2275,2276,22/09/2020,FPO,TAMBA TAM,10.0,,2154.11,Services,Nottingham,Uk
2276,2277,22/09/2020,FPO,EDWARD HANDS & LEW,350.0,,2164.11,,,
2277,2278,22/09/2020,BP,SAVE THE CHANGE,0.02,,2514.11,Savings,Nottingham,Uk
2278,2279,21/09/2020,TFR,R LAWRENCE,300.0,,2514.13,,,
2279,2280,21/09/2020,DEB,AMAZON.CO.UK*MY0NW,12.99,,2814.13,Amazon,Nottingham,Uk
2280,2281,21/09/2020,DEB,AMZNMKTPLACE AMAZO,10.99,,2827.12,Amazon,Nottingham,Uk
2281,2282,21/09/2020,FPI,ROTHERAS /CLI,,350.0,2838.11,Supplementary Income,Nottingham,Uk
2282,2283,21/09/2020,BP,SAVE THE CHANGE,1.39,,2488.11,Savings,Nottingham,Uk
2283,2284,21/09/2020,DEB,ORIENTAL MART HYDR,19.41,,2489.5,Groceries,Nottingham,Uk
2284,2285,21/09/2020,DEB,HOLLAND & BARRETT,10.98,,2508.91,Groceries,,
2285,2286,21/09/2020,DEB,GHOUSIA FOODS,17.98,,2519.89,Groceries,Nottingham,Uk
2286,2287,21/09/2020,DEB,LIDL GB NOTTINGHAM,17.24,,2537.87,Groceries,Nottingham,Uk
2287,2288,17/09/2020,DEB,Trading212UK,420.0,,2555.11,Investment,Nottingham,Uk
2288,2289,17/09/2020,BP,SAVE THE CHANGE,0.26,,2975.11,Savings,Nottingham,Uk
2289,2290,16/09/2020,DEB,Trading212UK,391.0,,2975.37,Investment,Nottingham,Uk
2290,2291,16/09/2020,DEB,AMZNMktplace,11.99,,3366.37,Amazon,Nottingham,Uk
2291,2292,16/09/2020,DEB,CO-OP GROUP 010661,9.75,,3378.36,Groceries,,
2292,2293,16/09/2020,DD,O2,16.63,,3388.11,Other Shopping,Nottingham,Uk
2293,2294,15/09/2020,FPO,TAMBA TAM,10.0,,3404.74,Services,Nottingham,Uk
2294,2295,15/09/2020,FPI,IISL CLIENT GBP SE,,391.0,3414.74,Supplementary Income,Nottingham,Uk
2295,2296,14/09/2020,FPO,LAURA FOGLIATA,7.0,,3023.74,Services,Nottingham,Uk
2296,2297,14/09/2020,BP,SAVE THE CHANGE,1.88,,3030.74,Savings,Nottingham,Uk
2297,2298,14/09/2020,DEB,HOLLAND & BARRETT,4.99,,3032.62,Groceries,,
2298,2299,14/09/2020,DEB,ORIENTAL MART HYDR,2.5,,3037.61,Groceries,Nottingham,Uk
2299,2300,14/09/2020,DEB,AMZNMKTPLACE AMAZO,33.24,,3040.11,Amazon,Nottingham,Uk
2300,2301,14/09/2020,DEB,LIDL GB NOTTINGHAM,9.39,,3073.35,Groceries,Nottingham,Uk
2301,2302,11/09/2020,FPO,ALICJA ALEXANDER,25.0,,3082.74,Services/Home Improvement,Nottingham,Uk
2302,2303,09/09/2020,BP,SAVE THE CHANGE,0.16,,3107.74,Savings,Nottingham,Uk
2303,2304,08/09/2020,FPO,TAMBA TAM,10.0,,3107.9,Services,Nottingham,Uk
2304,2305,08/09/2020,DEB,LIDL GB NOTTINGHAM,15.87,,3117.9,Groceries,Nottingham,Uk
2305,2306,08/09/2020,DEB,T K MAXX,9.97,,3133.77,Other Shopping,,
2306,2307,08/09/2020,BP,SAVE THE CHANGE,0.65,,3143.74,Savings,Nottingham,Uk
2307,2308,07/09/2020,DEB,AMZNMktplace,34.9,,3144.39,Amazon,Nottingham,Uk
2308,2309,07/09/2020,DEB,ORIENTAL MART HYDR,14.46,,3179.29,Groceries,Nottingham,Uk
2309,2310,07/09/2020,DEB,HOLLAND & BARRETT,4.99,,3193.75,Groceries,,
2310,2311,07/09/2020,BP,SAVE THE CHANGE,0.86,,3198.74,Savings,Nottingham,Uk
2311,2312,07/09/2020,DEB,AMAZON.CO.UK*921DE,16.15,,3199.6,Amazon,Nottingham,Uk
2312,2313,07/09/2020,DEB,AMZNMktplace,10.99,,3215.75,Amazon,Nottingham,Uk
2313,2314,04/09/2020,BP,SAVE THE CHANGE,0.86,,3226.74,Savings,Nottingham,Uk
2314,2315,03/09/2020,DEB,LIDL GB NOTTINGHAM,16.14,,3227.6,Groceries,Nottingham,Uk
2315,2316,03/09/2020,DEB,AMZNMktplace,,5.11,3243.74,Supplementary Income,Nottingham,Uk
2316,2317,03/09/2020,SO,TRISTRAMS LETTINGS,825.0,,3238.63,Home Improvement,Nottingham,Uk
2317,2318,03/09/2020,BP,SAVE THE CHANGE,1.6,,4063.63,Savings,Nottingham,Uk
2318,2319,02/09/2020,DEP,CLUB LLOYDS WAIVED,,3.0,4065.23,Amazon,Nottingham,Uk
2319,2320,02/09/2020,PAY,CLUB LLOYDS FEE,3.0,,4062.23,Bills,Nottingham,Uk
2320,2321,02/09/2020,DEB,AMZNMktplace,31.29,,4065.23,Supplementary Income,Nottingham,Uk
2321,2322,02/09/2020,DEB,AMZNMktplace,5.11,,4096.52,Amazon,Nottingham,Uk
2322,2323,02/09/2020,BP,SAVE THE CHANGE,0.02,,4101.63,Savings,Nottingham,Uk
2323,2324,01/09/2020,,INTEREST (GROSS),,2.42,4101.65,Interest,Nottingham,Uk
2324,2325,01/09/2020,DEB,AMZNMktplace,43.99,,4099.23,Amazon,Nottingham,Uk
2325,2326,01/09/2020,DEB,AMZNMKTPLACE AMAZO,10.99,,4143.22,Amazon,Nottingham,Uk
2326,2327,01/09/2020,DD,NOTTM CITY COUNC,119.0,,4154.21,Bills,Nottingham,Uk
2327,2328,01/09/2020,DD,THE RENEWABLE ENER,68.52,,4273.21,Bills,Nottingham,Uk
2328,2329,01/09/2020,DD,SEVERN TRENT WATER,25.7,,4341.73,Bills,Nottingham,Uk
2329,2330,01/09/2020,SO,ESAVINGS ACCOUNT,300.0,,4367.43,Savings,Nottingham,Uk
2330,2331,01/09/2020,DEB,Trading212UK,1000.0,,4667.43,Investment,Nottingham,Uk
2331,2332,28/08/2020,FPO,TAMBA TAM,10.0,,5667.43,Services,Nottingham,Uk
2332,2333,28/08/2020,DD,UCU B ACCOUNT,24.76,,5677.43,Others,Nottingham,Uk
2333,2334,28/08/2020,DD,TALKTALK LIMITED,19.95,,5702.19,Bills,Nottingham,Uk
2334,2335,28/08/2020,DD,UCU B ACCOUNT,10.0,,5722.14,Others,Nottingham,Uk
2335,2336,28/08/2020,BP,SAVE THE CHANGE,0.01,,5732.14,Savings,Nottingham,Uk
2336,2337,27/08/2020,DEB,AMZNMktplace,25.99,,5732.15,Amazon,Nottingham,Uk
2337,2338,27/08/2020,BGC,UNIV OF NOTTINGHAM,,3665.25,5758.14,Paycheck,Nottingham,Uk
2338,2339,26/08/2020,FPO,ALICJA ALEXANDER,25.0,,2092.89,Services/Home Improvement,Nottingham,Uk
2339,2340,25/08/2020,DEB,LIDL GB NOTTINGHAM,9.0,,2117.89,Groceries,Nottingham,Uk
2340,2341,25/08/2020,BP,SAVE THE CHANGE,0.05,,2126.89,Savings,Nottingham,Uk
2341,2342,24/08/2020,DEB,AMZNMktplace,31.96,,2126.94,Amazon,Nottingham,Uk
2342,2343,24/08/2020,DEB,Audible UK,7.99,,2158.9,Entertainment,Nottingham,Uk
2343,2344,24/08/2020,BP,SAVE THE CHANGE,2.81,,2166.89,Savings,Nottingham,Uk
2344,2345,24/08/2020,DEB,ONEBELOW,11.16,,2169.7,Other Shopping,,
2345,2346,24/08/2020,DEB,ORIENTAL MART HYDR,10.18,,2180.86,Groceries,Nottingham,Uk
2346,2347,24/08/2020,DEB,GREGGS PLC,1.0,,2191.04,Dine Out,,
2347,2348,21/08/2020,DEB,LIDL GB NOTTINGHAM,29.59,,2192.04,Groceries,Nottingham,Uk
2348,2349,21/08/2020,DEB,AMZNMktplace,23.99,,2221.63,Amazon,Nottingham,Uk
2349,2350,21/08/2020,DEB,AMAZON.CO.UK*8L7P1,10.27,,2245.62,Amazon,Nottingham,Uk
2350,2351,21/08/2020,BP,SAVE THE CHANGE,0.26,,2255.89,Savings,Nottingham,Uk
2351,2352,20/08/2020,DEB,AMZNMktplace,12.74,,2256.15,Amazon,Nottingham,Uk
2352,2353,20/08/2020,DEB,NBX*AT1.SPACE,30.0,,2268.89,Fitness,Nottingham,Uk
2353,2354,20/08/2020,BP,SAVE THE CHANGE,0.5,,2298.89,Savings,Nottingham,Uk
2354,2355,19/08/2020,DEB,SUMUP  *THE PLANT,6.5,,2299.39,,,
2355,2356,19/08/2020,BP,SAVE THE CHANGE,0.05,,2305.89,Savings,Nottingham,Uk
2356,2357,18/08/2020,DEB,AMZNMktplace,7.95,,2305.94,Amazon,Nottingham,Uk
2357,2358,18/08/2020,BP,SAVE THE CHANGE,0.32,,2313.89,Savings,Nottingham,Uk
2358,2359,17/08/2020,DEB,CAFFE NERO NOTTING,3.7,,2314.21,Dine Out,Nottingham,Uk
2359,2360,17/08/2020,DEB,WHEELHOUSE,13.98,,2317.91,Dine Out,Nottingham,Uk
2360,2361,17/08/2020,DD,O2,19.44,,2331.89,Other Shopping,Nottingham,Uk
2361,2362,17/08/2020,BP,SAVE THE CHANGE,1.52,,2351.33,Savings,Nottingham,Uk
2362,2363,17/08/2020,DEB,ORIENTAL MART HYDR,5.0,,2352.85,Groceries,Nottingham,Uk
2363,2364,17/08/2020,DEB,HOLLAND & BARRETT,4.0,,2357.85,Groceries,,
2364,2365,17/08/2020,DEB,GREGGS PLC,2.0,,2361.85,Dine Out,,
2365,2366,17/08/2020,DEB,AMZNMktplace,8.28,,2363.85,Amazon,Nottingham,Uk
2366,2367,17/08/2020,DEB,AMAZON.CO.UK*TU7DO,3.47,,2372.13,Amazon,Nottingham,Uk
2367,2368,14/08/2020,DEB,DANCE IN TIME BOUT,5.0,,2375.6,Clothes,,
2368,2369,14/08/2020,DEB,AMZNMKTPLACE AMAZO,74.73,,2380.6,Amazon,Nottingham,Uk
2369,2370,14/08/2020,FPO,ALICJA ALEXANDER,25.0,,2455.33,Services/Home Improvement,Nottingham,Uk
2370,2371,14/08/2020,BP,SAVE THE CHANGE,1.04,,2480.33,Savings,Nottingham,Uk
2371,2372,13/08/2020,DEB,Trading212UK,250.0,,2481.37,Investment,Nottingham,Uk
2372,2373,13/08/2020,DEB,LIDL GB NOTTINGHAM,30.35,,2731.37,Groceries,Nottingham,Uk
2373,2374,13/08/2020,DEB,AMAZON.CO.UK*9S008,6.61,,2761.72,Amazon,Nottingham,Uk
2374,2375,11/08/2020,BP,SAVE THE CHANGE,0.95,,2768.33,Savings,Nottingham,Uk
2375,2376,10/08/2020,DEB,AMZNMktplace,9.05,,2769.28,Amazon,Nottingham,Uk
2376,2377,10/08/2020,BP,SAVE THE CHANGE,1.44,,2778.33,Savings,Nottingham,Uk
2377,2378,10/08/2020,DEB,ORIENTAL MART HYDR,11.49,,2779.77,Groceries,Nottingham,Uk
2378,2379,10/08/2020,DEB,HOLLAND & BARRETT,4.99,,2791.26,Groceries,,
2379,2380,10/08/2020,DEB,STARBUCKS,3.5,,2796.25,Dine Out,,
2380,2381,10/08/2020,DEB,AMZNMKTPLACE AMAZO,49.96,,2799.75,Amazon,Nottingham,Uk
2381,2382,10/08/2020,DEB,GHOUSIA FOODS,14.62,,2849.71,Groceries,Nottingham,Uk
2382,2383,07/08/2020,CPT,LNK PO MIDDLETONBO,40.0,,2864.33,Cash,Middleton,Uk
2383,2384,07/08/2020,DEB,DANCE IN TIME BOUT,5.0,,2904.33,Clothes,,
2384,2385,05/08/2020,DEB,AMZ*momox co uk,,14.63,2909.33,Supplementary Income,Nottingham,Uk
2385,2386,04/08/2020,DEP,CLUB LLOYDS WAIVED,,3.0,2894.7,Supplementary Income,Nottingham,Uk
2386,2387,04/08/2020,PAY,CLUB LLOYDS FEE,3.0,,2891.7,Bills,Nottingham,Uk
2387,2388,04/08/2020,BP,SAVE THE CHANGE,0.15,,2894.7,Savings,Nottingham,Uk
2388,2389,03/08/2020,,INTEREST (GROSS),,2.25,2894.85,Interest,Nottingham,Uk
2389,2390,03/08/2020,DEB,COSTA COFFEE 43038,2.85,,2892.6,Dine Out,,
2390,2391,03/08/2020,FPO,TAMBA TAM,10.0,,2895.45,Services,Nottingham,Uk
2391,2392,03/08/2020,DD,NOTTM CITY COUNC,119.0,,2905.45,Bills,Nottingham,Uk
2392,2393,03/08/2020,DD,SEVERN TRENT WATER,25.7,,3024.45,Bills,Nottingham,Uk
2393,2394,03/08/2020,SO,TRISTRAMS LETTINGS,825.0,,3050.15,Home Improvement,Nottingham,Uk
2394,2395,03/08/2020,SO,ESAVINGS ACCOUNT,300.0,,3875.15,Savings,Nottingham,Uk
2395,2396,03/08/2020,BP,SAVE THE CHANGE,1.16,,4175.15,Savings,Nottingham,Uk
2396,2397,03/08/2020,DEB,GHOUSIA FOODS,8.53,,4176.31,Groceries,Nottingham,Uk
2397,2398,03/08/2020,DEB,ORIENTAL MART HYDR,5.94,,4184.84,Groceries,Nottingham,Uk
2398,2399,03/08/2020,DEB,HOLLAND & BARRETT,4.99,,4190.78,Groceries,,
2399,2400,03/08/2020,DEB,Trading212UK,1000.0,,4195.77,Investment,Nottingham,Uk
2400,2401,03/08/2020,DEB,AMZNMktplace,19.99,,5195.77,Amazon,Nottingham,Uk
2401,2402,03/08/2020,DEB,AMAZON.CO.UK AMAZO,,3.47,5215.76,Supplementary Income,Nottingham,Uk
2402,2403,31/07/2020,DEB,LIDL GB NOTTINGHAM,21.39,,5212.29,Groceries,Nottingham,Uk
2403,2404,31/07/2020,DD,UCU B ACCOUNT,24.76,,5233.68,Others,Nottingham,Uk
2404,2405,31/07/2020,BP,SAVE THE CHANGE,0.5,,5258.44,Savings,Nottingham,Uk
2405,2406,30/07/2020,DEB,Amazon.co.uk*7C4AV,4.5,,5258.94,Amazon,Nottingham,Uk
2406,2407,30/07/2020,DD,THE RENEWABLE ENER,23.25,,5263.44,Bills,Nottingham,Uk
2407,2408,30/07/2020,BGC,UNIV OF NOTTINGHAM,,3924.85,5286.69,Paycheck,Nottingham,Uk
2408,2409,29/07/2020,FPO,ALICJA ALEXANDER,25.0,,1361.84,Services/Home Improvement,Nottingham,Uk
2409,2410,29/07/2020,BP,SAVE THE CHANGE,0.18,,1386.84,Savings,Nottingham,Uk
2410,2411,28/07/2020,DEB,AMZNMktplace,10.82,,1387.02,Amazon,Nottingham,Uk
2411,2412,28/07/2020,BP,SAVE THE CHANGE,0.21,,1397.84,Savings,Nottingham,Uk
2412,2413,27/07/2020,DEB,AMZNMktplace,12.79,,1398.05,Amazon,Nottingham,Uk
2413,2414,27/07/2020,FPO,ROTHERAS SOLICITOR,350.0,,1410.84,Services,Nottingham,Uk
2414,2415,27/07/2020,DD,TALKTALK LIMITED,19.95,,1760.84,Bills,Nottingham,Uk
2415,2416,27/07/2020,BP,SAVE THE CHANGE,1.11,,1780.79,Savings,Nottingham,Uk
2416,2417,27/07/2020,DEB,ORIENTAL MART HYDR,6.85,,1781.9,Groceries,Nottingham,Uk
2417,2418,27/07/2020,DEB,CAFFE NERO 650 NOT,3.05,,1788.75,Dine Out,Nottingham,Uk
2418,2419,24/07/2020,DEB,Audible UK,7.99,,1791.8,Entertainment,Nottingham,Uk
2419,2420,24/07/2020,BP,SAVE THE CHANGE,0.04,,1799.79,Savings,Nottingham,Uk
2420,2421,23/07/2020,DEB,AMZNMktplace,44.98,,1799.83,Amazon,Nottingham,Uk
2421,2422,23/07/2020,DEB,AMZNMktplace,23.98,,1844.81,Amazon,Nottingham,Uk
2422,2423,22/07/2020,BP,SAVE THE CHANGE,0.62,,1868.79,Savings,Nottingham,Uk
2423,2424,21/07/2020,DEB,CO-OP GROUP 010661,22.38,,1869.41,Groceries,,
2424,2425,21/07/2020,BP,SAVE THE CHANGE,0.97,,1891.79,Savings,Nottingham,Uk
2425,2426,20/07/2020,DEB,AMZNMKTPLACE AMAZO,18.99,,1892.76,Amazon,Nottingham,Uk
2426,2427,20/07/2020,DEB,AMZNMktplace,13.99,,1911.75,Amazon,Nottingham,Uk
2427,2428,20/07/2020,DEB,CAFFE NERO 650 NOT,3.05,,1925.74,Dine Out,Nottingham,Uk
2428,2429,20/07/2020,BP,SAVE THE CHANGE,1.49,,1928.79,Savings,Nottingham,Uk
2429,2430,20/07/2020,DEB,ORIENTAL MART HYDR,8.9,,1930.28,Groceries,Nottingham,Uk
2430,2431,20/07/2020,DEB,HOLLAND & BARRETT,6.49,,1939.18,Groceries,,
2431,2432,20/07/2020,DEB,AMZNMktplace,45.49,,1945.67,Amazon,Nottingham,Uk
2432,2433,17/07/2020,DEB,AMZNMktplace,25.93,,1991.16,Amazon,Nottingham,Uk
2433,2434,17/07/2020,DEB,GHOUSIA FOODS,18.7,,2017.09,Groceries,Nottingham,Uk
2434,2435,17/07/2020,BP,SAVE THE CHANGE,1.11,,2035.79,Savings,Nottingham,Uk
2435,2436,16/07/2020,DEB,AMZNMktplace,22.62,,2036.9,Amazon,Nottingham,Uk
2436,2437,16/07/2020,DEB,GHOUSIA FOODS,21.27,,2059.52,Groceries,Nottingham,Uk
2437,2438,16/07/2020,DD,O2,16.44,,2080.79,Other Shopping,Nottingham,Uk
2438,2439,15/07/2020,FPO,ALICJA ALEXANDER,25.0,,2097.23,Services/Home Improvement,Nottingham,Uk
2439,2440,15/07/2020,BP,SAVE THE CHANGE,1.2,,2122.23,Savings,Nottingham,Uk
2440,2441,14/07/2020,DEB,Amazon.co.uk*K27LK,32.15,,2123.43,Amazon,Nottingham,Uk
2441,2442,14/07/2020,DEB,LIDL GB NOTTINGHAM,7.65,,2155.58,Groceries,Nottingham,Uk
2442,2443,14/07/2020,BP,SAVE THE CHANGE,0.01,,2163.23,Savings,Nottingham,Uk
2443,2444,13/07/2020,DEB,AMZNMKTPLACE AMAZO,17.99,,2163.24,Amazon,Nottingham,Uk
2444,2445,13/07/2020,BP,SAVE THE CHANGE,0.92,,2181.23,Savings,Nottingham,Uk
2445,2446,13/07/2020,DEB,Audible UK,18.0,,2182.15,Entertainment,Nottingham,Uk
2446,2447,13/07/2020,DEB,ORIENTAL MART HYDR,10.95,,2200.15,Groceries,Nottingham,Uk
2447,2448,13/07/2020,DEB,GREGGS PLC,2.0,,2211.1,Dine Out,,
2448,2449,13/07/2020,DEB,LIDL GB NOTTINGHAM,15.14,,2213.1,Groceries,Nottingham,Uk
2449,2450,13/07/2020,DEB,AMAZON.CO.UK*HR2BI,12.99,,2228.24,Amazon,Nottingham,Uk
2450,2451,09/07/2020,FPO,SALLY GOLDSTONE,321.0,,2241.23,Others,Nottingham,Uk
2451,2452,09/07/2020,BP,SAVE THE CHANGE,0.07,,2562.23,Savings,Nottingham,Uk
2452,2453,08/07/2020,DEB,LIDL GB NOTTINGHAM,14.93,,2562.3,Groceries,Nottingham,Uk
2453,2454,07/07/2020,BP,SAVE THE CHANGE,0.47,,2577.23,Savings,Nottingham,Uk
2454,2455,06/07/2020,DEB,DISNEY STORE NOTTI,13.0,,2577.7,Other Shopping,Nottingham,Uk
2455,2456,06/07/2020,DEB,ONEBELOW,7.53,,2590.7,Other Shopping,,
2456,2457,06/07/2020,DEB,GREGGS PLC,2.0,,2598.23,Dine Out,,
2457,2458,06/07/2020,BP,SAVE THE CHANGE,1.07,,2600.23,Savings,Nottingham,Uk
2458,2459,06/07/2020,DEB,STARBUCKS,3.55,,2601.3,Dine Out,,
2459,2460,03/07/2020,DEB,AMZNMktplace,31.97,,2604.85,Amazon,Nottingham,Uk
2460,2461,03/07/2020,DEB,LIDL GB NOTTINGHAM,20.62,,2636.82,Groceries,Nottingham,Uk
2461,2462,03/07/2020,DEB,AMZNMktplace,16.79,,2657.44,Amazon,Nottingham,Uk
2462,2463,03/07/2020,SO,TRISTRAMS LETTINGS,825.0,,2674.23,Home Improvement,Nottingham,Uk
2463,2464,02/07/2020,DEP,CLUB LLOYDS WAIVED,,3.0,3499.23,Supplementary Income,Nottingham,Uk
2464,2465,02/07/2020,PAY,CLUB LLOYDS FEE,3.0,,3496.23,Bills,Nottingham,Uk
2465,2466,02/07/2020,DEB,Trading212UK,1000.0,,3499.23,Investment,Nottingham,Uk
2466,2467,02/07/2020,BP,SAVE THE CHANGE,0.01,,4499.23,Savings,Nottingham,Uk
2467,2468,01/07/2020,,INTEREST (GROSS),,1.58,4499.24,Interest,Nottingham,Uk
2468,2469,01/07/2020,DEB,Trading212UK,6000.0,,4497.66,Investment,Nottingham,Uk
2469,2470,01/07/2020,DEB,AMZNMKTPLACE AMAZO,17.99,,10497.66,Amazon,Nottingham,Uk
2470,2471,01/07/2020,FPO,ALICJA ALEXANDER,25.0,,10515.65,Services/Home Improvement,Nottingham,Uk
2471,2472,01/07/2020,DD,NOTTM CITY COUNC,119.0,,10540.65,Bills,Nottingham,Uk
2472,2473,01/07/2020,DD,SEVERN TRENT WATER,25.7,,10659.65,Bills,Nottingham,Uk
2473,2474,01/07/2020,SO,ESAVINGS ACCOUNT,300.0,,10685.35,Savings,Nottingham,Uk
2474,2475,01/07/2020,BP,SAVE THE CHANGE,0.68,,10985.35,Savings,Nottingham,Uk
2475,2476,30/06/2020,DEB,Amazon.co.uk*7R62C,5.32,,10986.03,Amazon,Nottingham,Uk
2476,2477,30/06/2020,DD,UCU B ACCOUNT,24.76,,10991.35,Others,Nottingham,Uk
2477,2478,29/06/2020,DD,THE RENEWABLE ENER,88.54,,11016.11,Bills,Nottingham,Uk
2478,2479,29/06/2020,BP,SAVE THE CHANGE,1.52,,11104.65,Savings,Nottingham,Uk
2479,2480,29/06/2020,BGC,UNIV OF NOTTINGHAM,,9996.45,11106.17,Paycheck,Nottingham,Uk
2480,2481,29/06/2020,DEB,ONEBELOW,13.27,,1109.72,Other Shopping,,
2481,2482,29/06/2020,DEB,HOLLAND & BARRETT,9.67,,1122.99,Groceries,,
2482,2483,29/06/2020,DEB,ORIENTAL MART HYDR,2.6,,1132.66,Groceries,Nottingham,Uk
2483,2484,29/06/2020,DEB,GREGGS PLC,2.0,,1135.26,Dine Out,,
2484,2485,26/06/2020,DEB,LIDL GB NOTTINGHAM,19.94,,1137.26,Groceries,Nottingham,Uk
2485,2486,26/06/2020,DD,TALKTALK LIMITED,11.85,,1157.2,Bills,Nottingham,Uk
2486,2487,26/06/2020,BP,SAVE THE CHANGE,0.91,,1169.05,Savings,Nottingham,Uk
2487,2488,25/06/2020,DEB,GHOUSIA FOODS,22.09,,1169.96,Groceries,Nottingham,Uk
2488,2489,25/06/2020,BP,SAVE THE CHANGE,0.01,,1192.05,Savings,Nottingham,Uk
2489,2490,24/06/2020,DEB,Audible UK,7.99,,1192.06,Entertainment,Nottingham,Uk
2490,2491,24/06/2020,BP,SAVE THE CHANGE,0.05,,1200.05,Savings,Nottingham,Uk
2491,2492,24/06/2020,BGC,GOOGLE IRELAND,,65.41,1200.1,Supplementary Income,Nottingham,Uk
2492,2493,23/06/2020,DEB,Amazon.co.uk*UK1KA,9.95,,1134.69,Amazon,Nottingham,Uk
2493,2494,23/06/2020,BP,SAVE THE CHANGE,0.61,,1144.64,Savings,Nottingham,Uk
2494,2495,22/06/2020,DEB,LIDL GB NOTTINGHAM,12.39,,1145.25,Groceries,Nottingham,Uk
2495,2496,22/06/2020,DEB,GREGGS PLC,3.0,,1157.64,Dine Out,,
2496,2497,22/06/2020,BP,SAVE THE CHANGE,0.54,,1160.64,Savings,Nottingham,Uk
2497,2498,22/06/2020,DEB,T K MAXX,18.97,,1161.18,Other Shopping,,
2498,2499,22/06/2020,CPT,LNK INTU VICTORIA,40.0,,1180.15,Cash,Nottingham,Uk
2499,2500,19/06/2020,FPO,ALICJA ALEXANDER,25.0,,1220.15,Services/Home Improvement,Nottingham,Uk
2500,2501,19/06/2020,DEB,AMZNMktplace,9.49,,1245.15,Amazon,Nottingham,Uk
2501,2502,19/06/2020,BP,SAVE THE CHANGE,0.49,,1254.64,Savings,Nottingham,Uk
2502,2503,18/06/2020,DEB,LIDL GB NOTTINGHAM,10.51,,1255.13,Groceries,Nottingham,Uk
2503,2504,18/06/2020,BP,SAVE THE CHANGE,1.22,,1265.64,Savings,Nottingham,Uk
2504,2505,17/06/2020,DEB,GHOUSIA FOODS,18.68,,1266.86,Groceries,Nottingham,Uk
2505,2506,17/06/2020,DEB,CO-OP GROUP 010661,11.1,,1285.54,Groceries,,
2506,2507,16/06/2020,DD,O2,16.44,,1296.64,Other Shopping,Nottingham,Uk
2507,2508,16/06/2020,BP,SAVE THE CHANGE,0.15,,1313.08,Savings,Nottingham,Uk
2508,2509,15/06/2020,FPO,SALLY GOLDSTONE,155.0,,1313.23,Others,Nottingham,Uk
2509,2510,15/06/2020,DEB,AMZNMktplace,64.85,,1468.23,Amazon,Nottingham,Uk
2510,2511,15/06/2020,BP,SAVE THE CHANGE,1.47,,1533.08,Savings,Nottingham,Uk
2511,2512,15/06/2020,DEB,LIDL GB NOTTINGHAM,26.18,,1534.55,Groceries,Nottingham,Uk
2512,2513,12/06/2020,DEB,Amazon.co.uk*OS1EB,10.99,,1560.73,Amazon,Nottingham,Uk
2513,2514,12/06/2020,DEB,AMAZON.CO.UK*Z401P,14.36,,1571.72,Amazon,Nottingham,Uk
2514,2515,11/06/2020,BP,SAVE THE CHANGE,0.36,,1586.08,Savings,Nottingham,Uk
2515,2516,10/06/2020,DEB,GHOUSIA FOODS,13.64,,1586.44,Groceries,Nottingham,Uk
2516,2517,10/06/2020,BP,SAVE THE CHANGE,1.11,,1600.08,Savings,Nottingham,Uk
2517,2518,09/06/2020,,INTEREST (GROSS),,3.17,1601.19,Interest,Nottingham,Uk
2518,2519,09/06/2020,DEB,AMZNMktplace,177.87,,1598.02,Amazon,Nottingham,Uk
2519,2520,09/06/2020,DEB,AMZNMKTPLACE AMAZO,3.02,,1775.89,Amazon,Nottingham,Uk
2520,2521,08/06/2020,BP,SAVE THE CHANGE,1.14,,1778.91,Savings,Nottingham,Uk
2521,2522,08/06/2020,DEB,ORIENTAL MART HYDR,26.23,,1780.05,Groceries,Nottingham,Uk
2522,2523,08/06/2020,DEB,LIDL GB NOTTINGHAM,24.63,,1806.28,Groceries,Nottingham,Uk
2523,2524,05/06/2020,DEB,Trading212UK,520.0,,1830.91,Investment,Nottingham,Uk
2524,2525,05/06/2020,BGC,INFORMA UK LTD,,75.0,2350.91,Supplementary Income,Nottingham,Uk
2525,2526,04/06/2020,DEB,FARM FRESH NOTTING,18.0,,2275.91,Dine Out,Nottingham,Uk
2526,2527,04/06/2020,BP,SAVE THE CHANGE,0.64,,2293.91,Savings,Nottingham,Uk
2527,2528,03/06/2020,DEB,Trading212UK,320.0,,2294.55,Investment,Nottingham,Uk
2528,2529,03/06/2020,DEB,GHOUSIA FOODS,29.36,,2614.55,Groceries,Nottingham,Uk
2529,2530,03/06/2020,SO,TRISTRAMS LETTINGS,825.0,,2643.91,Home Improvement,Nottingham,Uk
2530,2531,03/06/2020,BP,SAVE THE CHANGE,0.01,,3468.91,Savings,Nottingham,Uk
2531,2532,02/06/2020,DEP,CLUB LLOYDS WAIVED,,3.0,3468.92,Supplementary Income,Nottingham,Uk
2532,2533,02/06/2020,PAY,CLUB LLOYDS FEE,3.0,,3465.92,Bills,Nottingham,Uk
2533,2534,02/06/2020,DEB,Trading212UK,1000.0,,3468.92,Investment,Nottingham,Uk
2534,2535,02/06/2020,DEB,AMZNMktplace,15.99,,4468.92,Amazon,Nottingham,Uk
2535,2536,02/06/2020,FPO,ALICJA ALEXANDER,25.0,,4484.91,Services/Home Improvement,Nottingham,Uk
2536,2537,01/06/2020,DD,NOTTM CITY COUNC,119.0,,4509.91,Bills,Nottingham,Uk
2537,2538,01/06/2020,DD,THE RENEWABLE ENER,29.55,,4628.91,Bills,Nottingham,Uk
2538,2539,01/06/2020,DD,SEVERN TRENT WATER,25.77,,4658.46,Bills,Nottingham,Uk
2539,2540,01/06/2020,SO,ESAVINGS ACCOUNT,300.0,,4684.23,Savings,Nottingham,Uk
2540,2541,01/06/2020,BP,SAVE THE CHANGE,2.41,,4984.23,Savings,Nottingham,Uk
2541,2542,29/05/2020,DEB,Trading212UK,1000.0,,4986.64,Investment,Nottingham,Uk
2542,2543,29/05/2020,DEB,LIDL GB NOTTINGHAM,23.31,,5986.64,Groceries,Nottingham,Uk
2543,2544,29/05/2020,DEB,AMZNMKTPLACE AMAZO,20.08,,6009.95,Amazon,Nottingham,Uk
2544,2545,29/05/2020,DEB,AMAZON.CO.UK*BZ9XP,9.2,,6030.03,Amazon,Nottingham,Uk
2545,2546,29/05/2020,DD,UCU B ACCOUNT,24.76,,6039.23,Others,Nottingham,Uk
2546,2547,28/05/2020,BP,SAVE THE CHANGE,1.29,,6063.99,Savings,Nottingham,Uk
2547,2548,28/05/2020,BGC,UNIV OF NOTTINGHAM,,3578.45,6065.28,Paycheck,Nottingham,Uk
2548,2549,27/05/2020,DEB,AMZN Mktp US*M74TR,10.56,,2486.83,Amazon,Nottingham,Uk
2549,2550,27/05/2020,DEB,CO-OP GROUP 010661,7.65,,2497.39,Groceries,,
2550,2551,27/05/2020,DEB,Amazon.co.uk*EE5SK,2.5,,2505.04,Amazon,Nottingham,Uk
2551,2552,26/05/2020,BP,SAVE THE CHANGE,1.23,,2507.54,Savings,Nottingham,Uk
2552,2553,26/05/2020,DEB,CO-OP GROUP 010661,14.25,,2508.77,Groceries,,
2553,2554,26/05/2020,DEB,Audible UK,7.99,,2523.02,Entertainment,Nottingham,Uk
2554,2555,26/05/2020,DEB,GHOUSIA FOODS,13.53,,2531.01,Groceries,Nottingham,Uk
2555,2556,22/05/2020,FPO,SALLY GOLDSTONE,45.0,,2544.54,Others,Nottingham,Uk
2556,2557,22/05/2020,BP,SAVE THE CHANGE,0.1,,2589.54,Savings,Nottingham,Uk
2557,2558,21/05/2020,DEB,AMZNMKTPLACE AMAZO,14.9,,2589.64,Amazon,Nottingham,Uk
2558,2559,21/05/2020,FPO,ALICJA ALEXANDER,25.0,,2604.54,Services/Home Improvement,Nottingham,Uk
2559,2560,19/05/2020,DEB,Trading212UK,500.0,,2629.54,Investment,Nottingham,Uk
2560,2561,19/05/2020,BP,SAVE THE CHANGE,0.34,,3129.54,Savings,Nottingham,Uk
2561,2562,18/05/2020,DEB,HOLLAND & BARRETT,21.66,,3129.88,Groceries,,
2562,2563,18/05/2020,DD,O2,16.44,,3151.54,Other Shopping,Nottingham,Uk
2563,2564,18/05/2020,BP,SAVE THE CHANGE,0.41,,3167.98,Savings,Nottingham,Uk
2564,2565,18/05/2020,DEB,ORIENTAL MART HYDR,19.84,,3168.39,Groceries,Nottingham,Uk
2565,2566,18/05/2020,DEB,Amazon.co.uk*W52CT,10.75,,3188.23,Amazon,Nottingham,Uk
2566,2567,18/05/2020,CPT,LOYD LOYD LOWER PA,40.0,,3198.98,Cash,Nottingham,Uk
2567,2568,15/05/2020,DEB,AMZNMKTPLACE AMAZO,,12.14,3238.98,Supplementary Income,Nottingham,Uk
2568,2569,15/05/2020,BP,SAVE THE CHANGE,1.51,,3226.84,Savings,Nottingham,Uk
2569,2570,14/05/2020,DEB,AMZN Mktp US*MC8CK,25.35,,3228.35,Amazon,Nottingham,Uk
2570,2571,14/05/2020,DEB,AMZNMKTPLACE AMAZO,12.14,,3253.7,Amazon,Nottingham,Uk
2571,2572,14/05/2020,BP,SAVE THE CHANGE,0.42,,3265.84,Savings,Nottingham,Uk
2572,2573,13/05/2020,DEB,CO-OP GROUP 010661,12.58,,3266.26,Groceries,,
2573,2574,13/05/2020,DEB,Trading212UK,500.0,,3278.84,Investment,Nottingham,Uk
2574,2575,11/05/2020,BP,SAVE THE CHANGE,1.56,,3778.84,Savings,Nottingham,Uk
2575,2576,11/05/2020,DEB,AMAZON.CO.UK AMAZO,,23.96,3780.4,Supplementary Income,Nottingham,Uk
2576,2577,11/05/2020,DEB,AMZ*Amazon.co.uk,,23.96,3756.44,Supplementary Income,Nottingham,Uk
2577,2578,11/05/2020,DEB,AMZNMktplace,68.46,,3732.48,Amazon,Nottingham,Uk
2578,2579,11/05/2020,DEB,GHOUSIA FOODS,39.03,,3800.94,Groceries,Nottingham,Uk
2579,2580,11/05/2020,DEB,AMZNMktplace,7.95,,3839.97,Amazon,Nottingham,Uk
2580,2581,07/05/2020,BP,SAVE THE CHANGE,0.67,,3847.92,Savings,Nottingham,Uk
2581,2582,06/05/2020,DEB,AMZNMKTPLACE AMAZO,23.71,,3848.59,Amazon,Nottingham,Uk
2582,2583,06/05/2020,DEB,LIDL GB NOTTINGHAM,22.62,,3872.3,Groceries,Nottingham,Uk
2583,2584,06/05/2020,DEB,AMAZON.CO.UK*WS0FS,15.0,,3894.92,Amazon,Nottingham,Uk
2584,2585,05/05/2020,FPO,ALICJA ALEXANDER,25.0,,3909.92,Services/Home Improvement,Nottingham,Uk
2585,2586,05/05/2020,BP,SAVE THE CHANGE,0.06,,3934.92,Savings,Nottingham,Uk
2586,2587,04/05/2020,DEP,CLUB LLOYDS WAIVED,,3.0,3934.98,Amazon,Nottingham,Uk
2587,2588,04/05/2020,PAY,CLUB LLOYDS FEE,3.0,,3931.98,Bills,Nottingham,Uk
2588,2589,04/05/2020,DEB,AMZNMKTPLACE AMAZO,23.94,,3934.98,Supplementary Income,Nottingham,Uk
2589,2590,04/05/2020,SO,TRISTRAMS LETTINGS,825.0,,3958.92,Home Improvement,Nottingham,Uk
2590,2591,04/05/2020,BP,SAVE THE CHANGE,2.07,,4783.92,Savings,Nottingham,Uk
2591,2592,04/05/2020,DEB,AMZNMktplace,7.57,,4785.99,Amazon,Nottingham,Uk
2592,2593,04/05/2020,DEB,AMZNMKTPLACE AMAZO,14.45,,4793.56,Amazon,Nottingham,Uk
2593,2594,04/05/2020,DEB,AMZNMKTPLACE AMAZO,2.82,,4808.01,Amazon,Nottingham,Uk
2594,2595,04/05/2020,DEB,AMZNMKTPLACE AMAZO,14.1,,4810.83,Amazon,Nottingham,Uk
2595,2596,04/05/2020,DEB,AMZNMKTPLACE AMAZO,12.99,,4824.93,Amazon,Nottingham,Uk
2596,2597,01/05/2020,,INTEREST (GROSS),,3.36,4837.92,Interest,Nottingham,Uk
2597,2598,01/05/2020,DEB,Trading212UK,1000.0,,4834.56,Investment,Nottingham,Uk
2598,2599,01/05/2020,DD,NOTTM CITY COUNC,119.0,,5834.56,Bills,Nottingham,Uk
2599,2600,01/05/2020,DD,SEVERN TRENT WATER,15.37,,5953.56,Bills,Nottingham,Uk
2600,2601,01/05/2020,SO,ESAVINGS ACCOUNT,300.0,,5968.93,Savings,Nottingham,Uk
2601,2602,30/04/2020,DD,UCU B ACCOUNT,24.76,,6268.93,Others,Nottingham,Uk
2602,2603,29/04/2020,BP,SAVE THE CHANGE,0.01,,6293.69,Savings,Nottingham,Uk
2603,2604,29/04/2020,BGC,UNIV OF NOTTINGHAM,,3578.85,6293.7,Paycheck,Nottingham,Uk
2604,2605,28/04/2020,DEB,AMZNMktplace,26.99,,2714.85,Amazon,Nottingham,Uk
2605,2606,28/04/2020,BP,SAVE THE CHANGE,0.05,,2741.84,Savings,Nottingham,Uk
2606,2607,27/04/2020,DEB,LIDL GB NOTTINGHAM,18.95,,2741.89,Groceries,Nottingham,Uk
2607,2608,27/04/2020,BP,SAVE THE CHANGE,0.01,,2760.84,Savings,Nottingham,Uk
2608,2609,27/04/2020,DEB,WWW.III.CO.UK DE,40.0,,2760.85,Investment,Nottingham,Uk
2609,2610,24/04/2020,DEB,AMAZON.CO.UK*PR1TB,79.0,,2800.85,Amazon,Nottingham,Uk
2610,2611,24/04/2020,DEB,Audible UK,7.99,,2879.85,Entertainment,Nottingham,Uk
2611,2612,23/04/2020,FPO,ALICJA ALEXANDER,25.0,,2887.84,Services/Home Improvement,Nottingham,Uk
2612,2613,23/04/2020,BP,SAVE THE CHANGE,0.04,,2912.84,Savings,Nottingham,Uk
2613,2614,22/04/2020,DEB,Amazon.co.uk*SE9IM,23.96,,2912.88,Amazon,Nottingham,Uk
2614,2615,22/04/2020,BP,SAVE THE CHANGE,0.7,,2936.84,Savings,Nottingham,Uk
2615,2616,21/04/2020,DEB,LIDL GB NOTTINGHAM,25.3,,2937.54,Groceries,Nottingham,Uk
2616,2617,20/04/2020,BP,SAVE THE CHANGE,1.33,,2962.84,Savings,Nottingham,Uk
2617,2618,20/04/2020,DEB,GHOUSIA FOODS,22.69,,2964.17,Groceries,Nottingham,Uk
2618,2619,20/04/2020,DEB,ECOTRICITY,126.81,,2986.86,Home Improvement,Nottingham,Uk
2619,2620,20/04/2020,DEB,AMZNMKTPLACE AMAZO,3.58,,3113.67,Amazon,Nottingham,Uk
2620,2621,17/04/2020,DEB,AMZNMKTPLACE AMAZO,2.59,,3117.25,Amazon,Nottingham,Uk
2621,2622,17/04/2020,BP,SAVE THE CHANGE,0.75,,3119.84,Savings,Nottingham,Uk
2622,2623,16/04/2020,DEB,AMZNMKTPLACE AMAZO,61.25,,3120.59,Amazon,Nottingham,Uk
2623,2624,16/04/2020,DD,O2,19.59,,3181.84,Other Shopping,Nottingham,Uk
2624,2625,16/04/2020,BP,SAVE THE CHANGE,0.82,,3201.43,Savings,Nottingham,Uk
2625,2626,15/04/2020,DEB,WWW.SO.ENERGY,199.56,,3202.25,Bills,Nottingham,Uk
2626,2627,15/04/2020,DEB,AMZNMKTPLACE AMAZO,25.0,,3401.81,Amazon,Nottingham,Uk
2627,2628,15/04/2020,DEB,LIDL GB NOTTINGHAM,18.62,,3426.81,Groceries,Nottingham,Uk
2628,2629,14/04/2020,DD,VIRGIN MEDIA PYMTS,14.43,,3445.43,Bills,Nottingham,Uk
2629,2630,14/04/2020,BP,SAVE THE CHANGE,1.63,,3459.86,Savings,Nottingham,Uk
2630,2631,14/04/2020,DEB,AMAZON.CO.UK*7V4G4,38.32,,3461.49,Amazon,Nottingham,Uk
2631,2632,14/04/2020,DEB,Audible UK,8.2,,3499.81,Entertainment,Nottingham,Uk
2632,2633,14/04/2020,DEB,WWW.III.CO.UK DE,1000.0,,3508.01,Investment,Nottingham,Uk
2633,2634,14/04/2020,DEB,WWW.III.CO.UK DE,500.0,,4508.01,Investment,Nottingham,Uk
2634,2635,09/04/2020,DEB,WWW.III.CO.UK DE,1000.0,,5008.01,Investment,Nottingham,Uk
2635,2636,09/04/2020,DEB,LIDL GB NOTTINGHAM,26.85,,6008.01,Groceries,Nottingham,Uk
2636,2637,09/04/2020,BP,SAVE THE CHANGE,0.36,,6034.86,Savings,Nottingham,Uk
2637,2638,08/04/2020,DEB,WWW.III.CO.UK DE,2000.0,,6035.22,Investment,Nottingham,Uk
2638,2639,08/04/2020,DEB,AMZNMktplace,26.72,,8035.22,Amazon,Nottingham,Uk
2639,2640,08/04/2020,DEB,AMZNMktplace,25.92,,8061.94,Amazon,Nottingham,Uk
2640,2641,07/04/2020,FPO,ALICJA ALEXANDER,25.0,,8087.86,Services/Home Improvement,Nottingham,Uk
2641,2642,07/04/2020,BP,SAVE THE CHANGE,0.05,,8112.86,Savings,Nottingham,Uk
2642,2643,06/04/2020,DEB,GHOUSIA FOODS,30.95,,8112.91,Groceries,Nottingham,Uk
2643,2644,06/04/2020,BP,SAVE THE CHANGE,2.4,,8143.86,Savings,Nottingham,Uk
2644,2645,06/04/2020,DEB,AMAZON.CO.UK*6Z8T6,25.76,,8146.26,Amazon,Nottingham,Uk
2645,2646,06/04/2020,DEB,AMZNMKTPLACE AMAZO,11.15,,8172.02,Amazon,Nottingham,Uk
2646,2647,06/04/2020,CPT,LNK UNIVERSITY PAR,40.0,,8183.17,Cash,Nottingham,Uk
2647,2648,06/04/2020,DEB,AMZNMKTPLACE AMAZO,30.25,,8223.17,Amazon,Nottingham,Uk
2648,2649,06/04/2020,DEB,LIDL GB NOTTINGHAM,25.44,,8253.42,Groceries,Nottingham,Uk
2649,2650,03/04/2020,SO,TRISTRAMS LETTINGS,825.0,,8278.86,Home Improvement,Nottingham,Uk
2650,2651,02/04/2020,DEP,CLUB LLOYDS WAIVED,,3.0,9103.86,Supplementary Income,Nottingham,Uk
2651,2652,02/04/2020,PAY,CLUB LLOYDS FEE,3.0,,9100.86,Bills,Nottingham,Uk
2652,2653,02/04/2020,BP,SAVE THE CHANGE,0.01,,9103.86,Savings,Nottingham,Uk
2653,2654,01/04/2020,,INTEREST (GROSS),,4.71,9103.87,Interest,Nottingham,Uk
2654,2655,01/04/2020,DEB,AMZNMktplace,21.99,,9099.16,Amazon,Nottingham,Uk
2655,2656,01/04/2020,DD,NOTTM CITY COUNC,115.47,,9121.15,Bills,Nottingham,Uk
2656,2657,01/04/2020,DD,SEVERN TRENT WATER,15.31,,9236.62,Bills,Nottingham,Uk
2657,2658,01/04/2020,SO,ESAVINGS ACCOUNT,300.0,,9251.93,Savings,Nottingham,Uk
2658,2659,31/03/2020,DD,UCU B ACCOUNT,24.76,,9551.93,Others,Nottingham,Uk
2659,2660,31/03/2020,DD,TALKTALK LIMITED,19.95,,9576.69,Bills,Nottingham,Uk
2660,2661,30/03/2020,BP,SAVE THE CHANGE,0.15,,9596.64,Savings,Nottingham,Uk
2661,2662,30/03/2020,BGC,UNIV OF NOTTINGHAM,,4336.21,9596.79,Paycheck,Nottingham,Uk
2662,2663,30/03/2020,DEB,AMZNMktplace,21.0,,5260.58,Amazon,Nottingham,Uk
2663,2664,30/03/2020,DEB,LIDL GB NOTTINGHAM,20.85,,5281.58,Groceries,Nottingham,Uk
2664,2665,27/03/2020,BP,SAVE THE CHANGE,0.87,,5302.43,Savings,Nottingham,Uk
2665,2666,26/03/2020,DEB,LIDL GB NOTTINGHAM,8.24,,5303.3,Groceries,Nottingham,Uk
2666,2667,26/03/2020,DEB,AMAZON.CO.UK*MC22D,7.89,,5311.54,Amazon,Nottingham,Uk
2667,2668,25/03/2020,BP,SAVE THE CHANGE,1.24,,5319.43,Savings,Nottingham,Uk
2668,2669,24/03/2020,DEB,AMZNMktplace,33.98,,5320.67,Amazon,Nottingham,Uk
2669,2670,24/03/2020,DEB,ORIENTAL MART,19.6,,5354.65,Groceries,Nottingham,Uk
2670,2671,24/03/2020,DEB,LIDL GB NOTTINGHAM,14.19,,5374.25,Groceries,Nottingham,Uk
2671,2672,24/03/2020,DEB,Audible UK,7.99,,5388.44,Entertainment,Nottingham,Uk
2672,2673,24/03/2020,FPO,ALICJA ALEXANDER,25.0,,5396.43,Services/Home Improvement,Nottingham,Uk
2673,2674,24/03/2020,BP,SAVE THE CHANGE,0.76,,5421.43,Savings,Nottingham,Uk
2674,2675,23/03/2020,DEB,YANKEE STORE,12.24,,5422.19,Other Shopping,,
2675,2676,23/03/2020,DD,HARLANDS,25.0,,5434.43,Fitness,Nottingham,Uk
2676,2677,23/03/2020,BP,SAVE THE CHANGE,1.38,,5459.43,Savings,Nottingham,Uk
2677,2678,23/03/2020,DEB,HOLLAND & BARRETT,24.68,,5460.81,Groceries,,
2678,2679,23/03/2020,DEB,AMAZON.CO.UK*425LQ,7.75,,5485.49,Amazon,Nottingham,Uk
2679,2680,20/03/2020,DEB,AMAZON.CO.UK*GF4UX,13.99,,5493.24,Amazon,Nottingham,Uk
2680,2681,20/03/2020,DEB,TESCO STORES 6735,7.2,,5507.23,Groceries,,
2681,2682,20/03/2020,CPT,LNK NOTTINGHAM UNI,40.0,,5514.43,Cash,Nottingham,Uk
2682,2683,20/03/2020,BP,SAVE THE CHANGE,0.5,,5554.43,Savings,Nottingham,Uk
2683,2684,19/03/2020,DEB,WWW.III.CO.UK DE,4000.0,,5554.93,Investment,Nottingham,Uk
2684,2685,19/03/2020,DEB,LIDL GB NOTTINGHAM,8.5,,9554.93,Groceries,Nottingham,Uk
2685,2686,19/03/2020,BP,SAVE THE CHANGE,0.39,,9563.43,Savings,Nottingham,Uk
2686,2687,19/03/2020,BGC,DWR CYMRU WELSH WA,,180.29,9563.82,Supplementary Income,Nottingham,Uk
2687,2688,18/03/2020,DEB,GHOUSIA FOODS,28.61,,9383.53,Groceries,Nottingham,Uk
2688,2689,18/03/2020,TFR,R LAWRENCE,,4350.57,9412.14,Supplementary Income,Nottingham,Uk
2689,2690,18/03/2020,BP,SAVE THE CHANGE,0.01,,5061.57,Savings,Nottingham,Uk
2690,2691,17/03/2020,DEB,AMZNMktplace,13.99,,5061.58,Amazon,Nottingham,Uk
2691,2692,17/03/2020,DEB,AMZ*Amazon.co.uk,,5.0,5075.57,Supplementary Income,Nottingham,Uk
2692,2693,16/03/2020,FPI,ANMF CREDIT,,959.1,5070.57,Supplementary Income,Nottingham,Uk
2693,2694,16/03/2020,DD,O2,14.72,,4111.47,Other Shopping,Nottingham,Uk
2694,2695,16/03/2020,BP,SAVE THE CHANGE,0.72,,4126.19,Savings,Nottingham,Uk
2695,2696,16/03/2020,DEB,IZ *BIRD & BLEND T,15.0,,4126.91,Dine Out,Nottingham,Uk
2696,2697,16/03/2020,DEB,LIDL GB NOTTINGHAM,10.29,,4141.91,Groceries,Nottingham,Uk
2697,2698,16/03/2020,FPI,Q WANG   14MAR20,,300.0,4152.2,Supplementary Income,Nottingham,Uk
2698,2699,16/03/2020,CPT,LNK TESCO LONG ROW,40.0,,3852.2,Cash,Nottingham,Uk
2699,2700,13/03/2020,DEB,WWW.III.CO.UK DE,5000.0,,3892.2,Investment,Nottingham,Uk
2700,2701,13/03/2020,DEB,HARLANDS GROUP,110.0,,8892.2,Fitness,Nottingham,Uk
2701,2702,13/03/2020,DEB,AMZNMktplace,31.99,,9002.2,Amazon,Nottingham,Uk
2702,2703,12/03/2020,CPT,LNK NOTTINGHAM UNI,40.0,,9034.19,Cash,Nottingham,Uk
2703,2704,12/03/2020,FPO,ALICJA ALEXANDER,25.0,,9074.19,Services/Home Improvement,Nottingham,Uk
2704,2705,12/03/2020,BP,SAVE THE CHANGE,0.01,,9099.19,Savings,Nottingham,Uk
2705,2706,11/03/2020,DEB,AMZNMktplace,12.99,,9099.2,Amazon,Nottingham,Uk
2706,2707,11/03/2020,BGC,GOOD ENERGY LTD,,290.18,9112.19,Supplementary Income,Nottingham,Uk
2707,2708,10/03/2020,FPO,TRISTRAMS LETTINGS,825.0,,8822.01,Home Improvement,Nottingham,Uk
2708,2709,09/03/2020,DEB,Amazon Prime*2S40E,79.0,,9647.01,Amazon,Nottingham,Uk
2709,2710,09/03/2020,CPT,LNK H&T NOTTINGHAM,50.0,,9726.01,Cash,Nottingham,Uk
2710,2711,06/03/2020,CPT,LNK NOTTINGHAM UNI,50.0,,9776.01,Cash,Nottingham,Uk
2711,2712,06/03/2020,FPO,SALLY GOLDSTONE,231.0,,9826.01,Others,Nottingham,Uk
2712,2713,06/03/2020,TFR,R LAWRENCE,84000.0,,10057.01,Account transfer,Nottingham,Uk
2713,2714,06/03/2020,BP,SAVE THE CHANGE,0.17,,94057.01,Savings,Nottingham,Uk
2714,2715,05/03/2020,DEB,CO-OP GROUP 010661,8.83,,94057.18,Groceries,,
2715,2716,03/03/2020,DEP,CLUB LLOYDS WAIVED,,3.0,94066.01,Supplementary Income,Nottingham,Uk
2716,2717,03/03/2020,PAY,CLUB LLOYDS FEE,3.0,,94063.01,Bills,Nottingham,Uk
2717,2718,03/03/2020,TFR,F/FLOW HOWELLS LEG,,83840.54,94066.01,Supplementary Income,Nottingham,Uk
2718,2719,03/03/2020,CPT,LNK NOTTINGHAM UNI,40.0,,10225.47,Cash,Nottingham,Uk
2719,2720,03/03/2020,BP,SAVE THE CHANGE,0.48,,10265.47,Savings,Nottingham,Uk
2720,2721,02/03/2020,,INTEREST (GROSS),,4.56,10265.95,Interest,Nottingham,Uk
2721,2722,02/03/2020,DEB,WWW.III.CO.UK DE,5000.0,,10261.39,Investment,Nottingham,Uk
2722,2723,02/03/2020,DEB,EB *REGGEATON WORK,13.52,,15261.39,Entertainment,London,Uk
2723,2724,02/03/2020,DD,SANTANDER MORTGAGE,959.1,,15274.91,Mortgage,Nottingham,Uk
2724,2725,02/03/2020,DD,DWR CYMRU W WATER,32.5,,16234.01,Bills,Nottingham,Uk
2725,2726,02/03/2020,SO,ESAVINGS ACCOUNT,300.0,,16266.51,Savings,Nottingham,Uk
2726,2727,02/03/2020,BP,SAVE THE CHANGE,0.37,,16566.51,Savings,Nottingham,Uk
2727,2728,02/03/2020,DEB,WWW.III.CO.UK DE,5000.0,,16566.88,Investment,Nottingham,Uk
2728,2729,02/03/2020,DEB,LIDL GB NOTTINGHAM,8.74,,21566.88,Groceries,Nottingham,Uk
2729,2730,02/03/2020,TFR,R LAWRENCE  01MAR20,,5000.0,21575.62,Supplementary Income,Nottingham,Uk
2730,2731,02/03/2020,DEB,LIDL GB NOTTINGHAM,7.89,,16575.62,Groceries,Nottingham,Uk
2731,2732,02/03/2020,CPT,LNK SAINSBURYS BAN,40.0,,16583.51,Cash,,
2732,2733,02/03/2020,TFR,R LAWRENCE  29FEB20,,5000.0,16623.51,Supplementary Income,Nottingham,Uk
2733,2734,28/02/2020,DD,UCU B ACCOUNT,24.76,,11623.51,Others,Nottingham,Uk
2734,2735,28/02/2020,DD,TALKTALK LIMITED,19.3,,11648.27,Bills,Nottingham,Uk
2735,2736,28/02/2020,BP,SAVE THE CHANGE,0.52,,11667.57,Savings,Nottingham,Uk
2736,2737,27/02/2020,DEB,AMZNMktplace,18.99,,11668.09,Amazon,Nottingham,Uk
2737,2738,27/02/2020,DEB,AMZNMKTPLACE AMAZO,6.49,,11687.08,Amazon,Nottingham,Uk
2738,2739,27/02/2020,BGC,UNIV OF NOTTINGHAM,,3436.27,11693.57,Paycheck,Nottingham,Uk
2739,2740,26/02/2020,DEB,WWW.FATSOMA.COM,8.0,,8257.3,Entertainment,Nottingham,Uk
2740,2741,26/02/2020,CPT,LNK NOTTINGHAM UNI,40.0,,8265.3,Cash,Nottingham,Uk
2741,2742,26/02/2020,BP,SAVE THE CHANGE,0.36,,8305.3,Savings,Nottingham,Uk
2742,2743,25/02/2020,DEB,AMZNMktplace,26.64,,8305.66,Amazon,Nottingham,Uk
2743,2744,25/02/2020,BP,SAVE THE CHANGE,0.01,,8332.3,Savings,Nottingham,Uk
2744,2745,24/02/2020,DEB,Audible UK,7.99,,8332.31,Entertainment,Nottingham,Uk
2745,2746,24/02/2020,BP,SAVE THE CHANGE,0.42,,8340.3,Savings,Nottingham,Uk
2746,2747,24/02/2020,DEB,TIMPSON LTD,20.0,,8340.72,Other Shopping,,
2747,2748,24/02/2020,DEB,LIDL GB NOTTINGHAM,7.58,,8360.72,Groceries,Nottingham,Uk
2748,2749,24/02/2020,DEB,WWW.SU.NOTTINGHAM.,44.0,,8368.3,Entertainment,Nottingham,Uk
2749,2750,21/02/2020,DEB,WWW.III.CO.UK DE,1100.0,,8412.3,Investment,Nottingham,Uk
2750,2751,21/02/2020,CPT,LNK UNIVERSITY PAR,40.0,,9512.3,Cash,Nottingham,Uk
2751,2752,21/02/2020,BP,SAVE THE CHANGE,0.69,,9552.3,Savings,Nottingham,Uk
2752,2753,20/02/2020,DEB,CO-OP GROUP 010661,13.31,,9552.99,Groceries,,
2753,2754,20/02/2020,BP,SAVE THE CHANGE,0.04,,9566.3,Savings,Nottingham,Uk
2754,2755,19/02/2020,DEB,AMZNMktplace,43.96,,9566.34,Amazon,Nottingham,Uk
2755,2756,19/02/2020,BP,SAVE THE CHANGE,0.12,,9610.3,Savings,Nottingham,Uk
2756,2757,18/02/2020,DEB,LIDL GB NOTTINGHAM,9.88,,9610.42,Groceries,Nottingham,Uk
2757,2758,18/02/2020,FPO,TRISTRAMS,22.5,,9620.3,Home Improvement,Nottingham,Uk
2758,2759,17/02/2020,CPT,LNK NOTTINGHAM UNI,40.0,,9642.8,Cash,Nottingham,Uk
2759,2760,17/02/2020,DD,O2,18.94,,9682.8,Other Shopping,Nottingham,Uk
2760,2761,17/02/2020,BP,SAVE THE CHANGE,1.25,,9701.74,Savings,Nottingham,Uk
2761,2762,17/02/2020,BGC,C C SWANSEA,,224.71,9702.99,Supplementary Income,Nottingham,Uk
2762,2763,17/02/2020,DEB,ATRIUM JUBILEE 1,3.4,,9478.28,Dine Out,Nottingham,Uk
2763,2764,17/02/2020,DEB,Audible UK,18.0,,9481.68,Entertainment,Nottingham,Uk
2764,2765,17/02/2020,DEB,LIDL GB NOTTINGHAM,12.35,,9499.68,Groceries,Nottingham,Uk
2765,2766,14/02/2020,CPT,LNK NOTTINGHAM UNI,40.0,,9512.03,Cash,Nottingham,Uk
2766,2767,14/02/2020,BP,SAVE THE CHANGE,0.83,,9552.03,Savings,Nottingham,Uk
2767,2768,13/02/2020,DEB,CO-OP GROUP 010661,11.17,,9552.86,Groceries,,
2768,2769,11/02/2020,BP,SAVE THE CHANGE,0.45,,9564.03,Savings,Nottingham,Uk
2769,2770,10/02/2020,DEB,TIMPSON LTD,15.0,,9564.48,Other Shopping,,
2770,2771,10/02/2020,DEB,GHOUSIA FOODS,36.55,,9579.48,Groceries,Nottingham,Uk
2771,2772,10/02/2020,CPT,LNK NOTTINGHAM UNI,40.0,,9616.03,Cash,Nottingham,Uk
2772,2773,10/02/2020,BP,SAVE THE CHANGE,0.7,,9656.03,Savings,Nottingham,Uk
2773,2774,10/02/2020,DEB,CO-OP GROUP 010661,8.3,,9656.73,Groceries,,
2774,2775,06/02/2020,BP,SAVE THE CHANGE,0.01,,9665.03,Savings,Nottingham,Uk
2775,2776,05/02/2020,DEB,POST OFFICE COUNTE,46.99,,9665.04,Others,Nottingham,Uk
2776,2777,05/02/2020,FPO,BORIS REMOVALS,1100.0,,9712.03,Others,Nottingham,Uk
2777,2778,05/02/2020,BP,SAVE THE CHANGE,0.6,,10812.03,Savings,Nottingham,Uk
2778,2779,04/02/2020,DEP,CLUB LLOYDS WAIVED,,3.0,10812.63,Supplementary Income,Nottingham,Uk
2779,2780,04/02/2020,PAY,CLUB LLOYDS FEE,3.0,,10809.63,Bills,Nottingham,Uk
2780,2781,04/02/2020,DEB,SAINSBURYS S/MKTS,30.4,,10812.63,Groceries,,
2781,2782,04/02/2020,BP,SAVE THE CHANGE,0.75,,10843.03,Savings,Nottingham,Uk
2782,2783,03/02/2020,,INTEREST (GROSS),,5.21,10843.78,Interest,Nottingham,Uk
2783,2784,03/02/2020,DEB,ZINCO LOUNGE,16.25,,10838.57,Dine Out,Swansea,Uk
2784,2785,03/02/2020,DEB,SQ *TIKI BAR,5.0,,10854.82,Dine Out,Nottingham,Uk
2785,2786,03/02/2020,CPT,LNK PO THE CITYOFS,50.0,,10859.82,Cash,,
2786,2787,03/02/2020,DD,SANTANDER MORTGAGE,959.09,,10909.82,Mortgage,Nottingham,Uk
2787,2788,03/02/2020,DD,GOOD ENERGY LTD,50.0,,11868.91,Bills,Nottingham,Uk
2788,2789,03/02/2020,DD,DWR CYMRU W WATER,32.5,,11918.91,Bills,Nottingham,Uk
2789,2790,03/02/2020,SO,ESAVINGS ACCOUNT,300.0,,11951.41,Savings,Nottingham,Uk
2790,2791,03/02/2020,BP,SAVE THE CHANGE,0.4,,12251.41,Savings,Nottingham,Uk
2791,2792,03/02/2020,DEB,WILKO RETAIL LIMIT,18.0,,12251.81,Other Shopping,,
2792,2793,03/02/2020,DEB,Brontosaurus Vegan,16.62,,12269.81,Dine Out,Swansea,Uk
2793,2794,03/02/2020,DEB,CORGI HOMEPLAN,24.98,,12286.43,Home Improvement,Nottingham,Uk
2794,2795,31/01/2020,CPT,LNK M&S SWANSEA,50.0,,12311.41,Cash,Swansea,Uk
2795,2796,31/01/2020,FPO,TRISTRAMS,1585.0,,12361.41,Home Improvement,Nottingham,Uk
2796,2797,31/01/2020,DD,UCU B ACCOUNT,24.76,,13946.41,Others,Nottingham,Uk
2797,2798,31/01/2020,BGC,SWANSEA UNI - PAY,,3288.72,13971.17,Paycheck,Swansea,Uk
2798,2799,30/01/2020,BGC,UNIV OF NOTTINGHAM,,3412.29,10682.45,Paycheck,Nottingham,Uk
2799,2800,29/01/2020,BP,SAVE THE CHANGE,0.11,,7270.16,Savings,Nottingham,Uk
2800,2801,28/01/2020,DEB,AMZNMktplace,65.89,,7270.27,Amazon,Nottingham,Uk
2801,2802,28/01/2020,DD,TALKTALK LIMITED,19.95,,7336.16,Bills,Swansea,Uk
2802,2803,27/01/2020,FPO,BORIS REMOVALS,600.0,,7356.11,Others,Nottingham,Uk
2803,2804,27/01/2020,BP,SAVE THE CHANGE,0.35,,7956.11,Savings,Nottingham,Uk
2804,2805,27/01/2020,DEB,GRAPE TREE,27.66,,7956.46,Groceries,Leicester,Uk
2805,2806,27/01/2020,DEP,LOYD 802 OXFORD ST,,35.6,7984.12,Supplementary Income,Nottingham,Uk
2806,2807,27/01/2020,CPT,LOYD LOYD 802 OXFO,40.0,,7948.52,Cash,Swansea,Uk
2807,2808,24/01/2020,DEB,Audible UK,7.99,,7988.52,Entertainment,Nottingham,Uk
2808,2809,24/01/2020,CPT,LNK TESCO FABIAN W,40.0,,7996.51,Cash,Swansea,Uk
2809,2810,24/01/2020,BP,SAVE THE CHANGE,0.48,,8036.51,Savings,Nottingham,Uk
2810,2811,24/01/2020,BGC,CARDIFF MET EX A/C,,22.2,8036.99,Supplementary Income,Nottingham,Uk
2811,2812,23/01/2020,DEB,TESCO STORES 4628,5.52,,8014.79,Groceries,,
2812,2813,22/01/2020,DD,CORGI HOMEPLAN,18.0,,8020.31,Home Improvement,Nottingham,Uk
2813,2814,21/01/2020,BP,SAVE THE CHANGE,0.2,,8038.31,Savings,Nottingham,Uk
2814,2815,20/01/2020,DEB,MOWGLI STREET FOOD,35.8,,8038.51,Dine Out,Nottingham,Uk
2815,2816,20/01/2020,FPO,TRISTRAMS LETTINGS,190.0,,8074.31,Home Improvement,Nottingham,Uk
2816,2817,20/01/2020,BP,SAVE THE CHANGE,0.02,,8264.31,Savings,Nottingham,Uk
2817,2818,20/01/2020,CPT,LNK 49-51 CLUMBER,40.0,,8264.33,Cash,Nottingham,Uk
2818,2819,20/01/2020,DEB,BUNNEYS BIKES LIMI,21.98,,8304.33,Other Shopping,Nottingham,Uk
2819,2820,17/01/2020,BP,SAVE THE CHANGE,0.9,,8326.31,Savings,Nottingham,Uk
2820,2821,16/01/2020,DEB,TFW RAIL SERVICES,98.2,,8327.21,Travel,,
2821,2822,16/01/2020,DEB,TESCO STORES 5660,34.9,,8425.41,Groceries,,
2822,2823,16/01/2020,DD,O2,18.55,,8460.31,Other Shopping,Nottingham,Uk
2823,2824,15/01/2020,CPT,LNK ARRIVA TRAINS,40.0,,8478.86,Cash,,
2824,2825,15/01/2020,BP,SAVE THE CHANGE,0.01,,8518.86,Savings,Nottingham,Uk
2825,2826,14/01/2020,DEB,AMZNMktplace,9.99,,8518.87,Amazon,Nottingham,Uk
2826,2827,14/01/2020,BP,SAVE THE CHANGE,0.24,,8528.86,Savings,Nottingham,Uk
2827,2828,13/01/2020,DEB,WM MORRISONS STORE,15.8,,8529.1,Groceries,,
2828,2829,13/01/2020,DEB,T K MAXX,13.96,,8544.9,Other Shopping,,
2829,2830,13/01/2020,CPT,LNK SAINSBURYS BAN,80.0,,8558.86,Cash,,
2830,2831,13/01/2020,CPT,LNK PO THE CITYOFS,50.0,,8638.86,Cash,,
2831,2832,10/01/2020,DEB,Audible UK,18.0,,8688.86,Entertainment,Swansea,Uk
2832,2833,10/01/2020,CPT,LNK TESCO FABIAN W,40.0,,8706.86,Cash,Swansea,Uk
2833,2834,10/01/2020,BP,SAVE THE CHANGE,0.95,,8746.86,Savings,Nottingham,Uk
2834,2835,09/01/2020,DEB,Amazon.co.uk*4L6WG,63.1,,8747.81,Amazon,Nottingham,Uk
2835,2836,09/01/2020,DEB,AMZNMktplace,19.99,,8810.91,Amazon,Nottingham,Uk
2836,2837,09/01/2020,DEB,Amazon.co.uk*AJ1IW,18.96,,8830.9,Amazon,Nottingham,Uk
2837,2838,09/01/2020,BP,SAVE THE CHANGE,0.03,,8849.86,Savings,Nottingham,Uk
2838,2839,08/01/2020,DEB,HOWELLS SOLICITORS,180.0,,8849.89,Bills,Swansea,Uk
2839,2840,08/01/2020,DEB,AMZNMktplace,3.97,,9029.89,Amazon,Nottingham,Uk
2840,2841,08/01/2020,CPT,LOYD LOYD 802 OXFO,40.0,,9033.86,Cash,Swansea,Uk
2841,2842,08/01/2020,BP,SAVE THE CHANGE,0.13,,9073.86,Savings,Nottingham,Uk
2842,2843,07/01/2020,DEB,AIRBNB * HM9YBKEXN,469.87,,9073.99,Hotels,,
2843,2844,07/01/2020,DD,THE GYM LTD,14.99,,9543.86,Fitness,Swansea,Uk
2844,2845,06/01/2020,BP,SAVE THE CHANGE,0.46,,9558.85,Savings,Nottingham,Uk
2845,2846,06/01/2020,CPT,LNK M&S SWANSEA,50.0,,9559.31,Cash,Swansea,Uk
2846,2847,03/01/2020,DEP,CLUB LLOYDS WAIVED,,3.0,9609.31,Supplementary Income,Nottingham,Uk
2847,2848,03/01/2020,PAY,CLUB LLOYDS FEE,3.0,,9606.31,Bills,Swansea,Uk
2848,2849,03/01/2020,DEB,NON-GBP PURCH FEE,0.5,,9609.31,Others,Nottingham,Uk
2849,2850,03/01/2020,DEB,NON-GBP TRANS FEE,2.22,,9609.81,Others,Nottingham,Uk
2850,2851,03/01/2020,DEB,ATHLEAN-X,74.54,,9612.03,Entertainment,Swansea,Uk
2851,2852,03/01/2020,DD,ZURICH,24.82,,9686.57,Insurance,Swansea,Uk
2852,2853,02/01/2020,,INTEREST (GROSS),,5.05,9711.39,Interest,Swansea,Uk
2853,2854,02/01/2020,DD,SANTANDER MORTGAGE,959.09,,9706.34,Mortgage,Swansea,Uk
2854,2855,02/01/2020,DD,CC SWANSEA C.TAX,147.0,,10665.43,Bills,Swansea,Uk
2855,2856,02/01/2020,DD,GOOD ENERGY LTD,50.0,,10812.43,Bills,Swansea,Uk
2856,2857,02/01/2020,DD,DWR CYMRU W WATER,32.5,,10862.43,Bills,Swansea,Uk
2857,2858,02/01/2020,SO,ESAVINGS ACCOUNT,300.0,,10894.93,Savings,Nottingham,Uk
2858,2859,02/01/2020,BP,SAVE THE CHANGE,0.5,,11194.93,Savings,Nottingham,Uk
2859,2860,02/01/2020,DEB,NOSDA STUDIO HOSTE,24.9,,11195.43,Hotels,Cardiff,Uk
2860,2861,31/12/2019,DEB,Electrolux plc,130.0,,11220.33,Home Improvement,Swansea,Uk
2861,2862,31/12/2019,DEB,WILKO RETAIL LIMIT,3.6,,11350.33,Other Shopping,,
2862,2863,31/12/2019,DEB,GREGGS PLC,2.0,,11353.93,Dine Out,,
2863,2864,31/12/2019,DD,UCU B ACCOUNT,24.76,,11355.93,Others,Swansea,Uk
2864,2865,31/12/2019,DD,TALKTALK LIMITED,19.95,,11380.69,Bills,Swansea,Uk
2865,2866,31/12/2019,BGC,SWANSEA UNI - PAY,,3289.12,11400.64,Paycheck,Swansea,Uk
2866,2867,30/12/2019,CPT,LNK SWANSEA CITY C,50.0,,8111.52,Cash,Swansea,Uk
2867,2868,30/12/2019,CPT,LNK M&S SWANSEA,40.0,,8161.52,Cash,Swansea,Uk
2868,2869,27/12/2019,BP,SAVE THE CHANGE,0.01,,8201.52,Savings,Swansea,Uk
2869,2870,27/12/2019,BGC,GOOGLE IRELAND,,63.7,8201.53,Supplementary Income,Swansea,Uk
2870,2871,24/12/2019,DEB,SAINSBURYS S/MKTS,13.0,,8137.83,Groceries,,
2871,2872,24/12/2019,DEB,Audible UK,7.99,,8150.83,Entertainment,Swansea,Uk
2872,2873,24/12/2019,BP,SAVE THE CHANGE,2.47,,8158.82,Savings,Swansea,Uk
2873,2874,23/12/2019,DEB,Brontosaurus Vegan,27.14,,8161.29,Dine Out,Swansea,Uk
2874,2875,23/12/2019,DEB,Amazon.co.uk*834HJ,15.54,,8188.43,Amazon,Swansea,Uk
2875,2876,23/12/2019,DEB,TURKISH LTD 311058,13.35,,8203.97,Travel,,
2876,2877,23/12/2019,DEB,MARKS&SPENCER PLC,4.5,,8217.32,Clothes,,
2877,2878,23/12/2019,DD,HARLANDS,25.0,,8221.82,Fitness,Swansea,Uk
2878,2879,23/12/2019,DD,CORGI HOMEPLAN,18.0,,8246.82,Home Improvement,Swansea,Uk
2879,2880,23/12/2019,BP,SAVE THE CHANGE,0.91,,8264.82,Savings,Swansea,Uk
2880,2881,23/12/2019,DEB,AMZNMktplace,3.45,,8265.73,Amazon,Swansea,Uk
2881,2882,23/12/2019,CPT,LNK M&S SWANSEA,50.0,,8269.18,Cash,Swansea,Uk
2882,2883,23/12/2019,DEB,GODADDY.COM EUROPE,38.64,,8319.18,Others,Swansea,Uk
2883,2884,23/12/2019,DEB,IZ *Yogaya CIC,53.0,,8357.82,Fitness,,
2884,2885,23/12/2019,FPO,AMELIA TERESZKIEWI,35.0,,8410.82,Services,Swansea,Uk
2885,2886,19/12/2019,BP,SAVE THE CHANGE,0.8,,8445.82,Savings,Swansea,Uk
2886,2887,18/12/2019,DEB,TFW RAIL SERVICES,12.2,,8446.62,Travel,,
2887,2888,17/12/2019,CPT,LNK QUEEN STREET,20.0,,8458.82,Cash,Belfast,Uk
2888,2889,16/12/2019,DD,O2,18.39,,8478.82,Other Shopping,Swansea,Uk
2889,2890,16/12/2019,BP,SAVE THE CHANGE,1.81,,8497.21,Savings,Swansea,Uk
2890,2891,16/12/2019,DEB,Brontosaurus Vegan,15.65,,8499.02,Dine Out,Swansea,Uk
2891,2892,16/12/2019,DEB,MARKS&SPENCER PLC,4.7,,8514.67,Clothes,,
2892,2893,16/12/2019,FPO,CRYSTAL CLEAR,20.0,,8519.37,Other Shopping,Bristol,Uk
2893,2894,13/12/2019,DEB,AMZNMKTPLACE AMAZO,2.81,,8539.37,Amazon,Swansea,Uk
2894,2895,13/12/2019,DEB,AMAZON.CO.UK*CQ7LW,5.03,,8542.18,Amazon,Swansea,Uk
2895,2896,13/12/2019,CPT,LNK FULTON HOUSE,50.0,,8547.21,Cash,Swansea,Uk
2896,2897,13/12/2019,BGC,SWANSEA UNIVERSITY,,2628.14,8597.21,Supplementary Income,Swansea,Uk
2897,2898,11/12/2019,DEB,TESCO STORES 4628,3.0,,5969.07,Groceries,,
2898,2899,10/12/2019,CPT,LNK TESCO FABIAN W,40.0,,5972.07,Cash,Swansea,Uk
2899,2900,09/12/2019,DD,THE GYM LTD,14.99,,6012.07,Fitness,Swansea,Uk
2900,2901,09/12/2019,BP,SAVE THE CHANGE,1.39,,6027.06,Savings,Swansea,Uk
2901,2902,09/12/2019,DEB,Brontosaurus Vegan,18.62,,6028.45,Dine Out,Swansea,Uk
2902,2903,09/12/2019,DEB,MARKS&SPENCER PLC,2.5,,6047.07,Clothes,,
2903,2904,09/12/2019,DEB,VIRGIN MEDIA PYMTS,96.5,,6049.57,Bills,Swansea,Uk
2904,2905,09/12/2019,DEB,AMAZON.CO.UK*0P5YW,8.99,,6146.07,Amazon,Swansea,Uk
2905,2906,09/12/2019,CPT,LNK M&S SWANSEA,40.0,,6155.06,Cash,Swansea,Uk
2906,2907,06/12/2019,CPT,LNK TESCO FABIAN W,40.0,,6195.06,Cash,Swansea,Uk
2907,2908,06/12/2019,BP,SAVE THE CHANGE,0.24,,6235.06,Savings,Swansea,Uk
2908,2909,06/12/2019,BGC,SHAREDEALING HSDL,,2.49,6235.3,Supplementary Income,Swansea,Uk
2909,2910,05/12/2019,DEB,AMAZON.CO.UK*JX94J,9.76,,6232.81,Amazon,Swansea,Uk
2910,2911,04/12/2019,DEB,TESCO STORES 4628,2.0,,6242.57,Groceries,,
2911,2912,03/12/2019,DEP,CLUB LLOYDS WAIVED,,3.0,6244.57,Supplementary Income,Swansea,Uk
2912,2913,03/12/2019,PAY,CLUB LLOYDS FEE,3.0,,6241.57,Bills,Swansea,Uk
2913,2914,03/12/2019,DD,ZURICH,24.82,,6244.57,Insurance,Swansea,Uk
2914,2915,02/12/2019,,INTEREST (GROSS),,4.5,6269.39,Interest,Swansea,Uk
2915,2916,02/12/2019,CPT,LNK FABIAN WAY,50.0,,6264.89,Cash,Swansea,Uk
2916,2917,02/12/2019,DD,SANTANDER MORTGAGE,959.09,,6314.89,Mortgage,Swansea,Uk
2917,2918,02/12/2019,DD,CC SWANSEA C.TAX,147.0,,7273.98,Bills,Swansea,Uk
2918,2919,02/12/2019,DD,GOOD ENERGY LTD,50.0,,7420.98,Bills,Swansea,Uk
2919,2920,02/12/2019,DD,DWR CYMRU W WATER,32.5,,7470.98,Bills,Swansea,Uk
2920,2921,02/12/2019,SO,ESAVINGS ACCOUNT,300.0,,7503.48,Savings,Swansea,Uk
2921,2922,02/12/2019,BP,SAVE THE CHANGE,1.81,,7803.48,Savings,Swansea,Uk
2922,2923,02/12/2019,DEB,WILKO RETAIL LIMIT,22.4,,7805.29,Other Shopping,,
2923,2924,02/12/2019,DEB,MARKS&SPENCER PLC,7.2,,7827.69,Clothes,,
2924,2925,02/12/2019,DEB,SAINSBURYS S/MKTS,40.9,,7834.89,Groceries,,
2925,2926,02/12/2019,CPT,LNK M&S SWANSEA,50.0,,7875.79,Cash,Swansea,Uk
2926,2927,29/11/2019,DEB,AMZNMktplace,13.99,,7925.79,Amazon,Swansea,Uk
2927,2928,29/11/2019,DEB,COFFEE NO 1 SWANSE,6.7,,7939.78,Dine Out,Swansea,Uk
2928,2929,29/11/2019,DD,UCU B ACCOUNT,24.76,,7946.48,Others,Swansea,Uk
2929,2930,29/11/2019,BGC,SWANSEA UNI - PAY,,3289.12,7971.24,Paycheck,Swansea,Uk
2930,2931,29/11/2019,BGC,SWANSEA UNIVERSITY,,190.5,4682.12,Supplementary Income,Swansea,Uk
2931,2932,28/11/2019,FPO,AMELIA TERESZKIEWI,15.0,,4491.62,Services,Swansea,Uk
2932,2933,28/11/2019,CPT,LNK M&S SWANSEA,40.0,,4506.62,Cash,Swansea,Uk
2933,2934,28/11/2019,FPO,SALLY GOLDSTONE,28.0,,4546.62,Others,Swansea,Uk
2934,2935,27/11/2019,DEB,THE BIKE HUB,35.0,,4574.62,Other Shopping,,
2935,2936,27/11/2019,DD,TALKTALK LIMITED,19.95,,4609.62,Bills,Swansea,Uk
2936,2937,27/11/2019,BGC,SHAREDEALING HSDL,,200.0,4629.57,Supplementary Income,Swansea,Uk
2937,2938,25/11/2019,DD,HARLANDS,25.0,,4429.57,Fitness,Swansea,Uk
2938,2939,25/11/2019,BP,SAVE THE CHANGE,0.63,,4454.57,Savings,Swansea,Uk
2939,2940,25/11/2019,DEB,Brontosaurus Vegan,24.39,,4455.2,Dine Out,Swansea,Uk
2940,2941,25/11/2019,DEB,THE BIKE HUB,20.0,,4479.59,Other Shopping,,
2941,2942,25/11/2019,DEB,Brontosaurus Vegan,14.99,,4499.59,Dine Out,Swansea,Uk
2942,2943,25/11/2019,DEB,Audible UK,7.99,,4514.58,Entertainment,Swansea,Uk
2943,2944,25/11/2019,CPT,LOYD LOYD 802 OXFO,50.0,,4522.57,Cash,Swansea,Uk
2944,2945,22/11/2019,CPT,LNK TESCO FABIAN W,20.0,,4572.57,Cash,Swansea,Uk
2945,2946,22/11/2019,DD,CORGI HOMEPLAN,18.0,,4592.57,Home Improvement,Swansea,Uk
2946,2947,22/11/2019,BGC,SWANSEA UNIVERSITY,,186.29,4610.57,Supplementary Income,Swansea,Uk
2947,2948,20/11/2019,CPT,LNK TESCO FABIAN W,40.0,,4424.28,Cash,Swansea,Uk
2948,2949,20/11/2019,BP,SAVE THE CHANGE,0.96,,4464.28,Savings,Swansea,Uk
2949,2950,19/11/2019,DEB,AMZNMktplace,3.04,,4465.24,Amazon,Swansea,Uk
2950,2951,18/11/2019,DD,O2,38.42,,4468.28,Other Shopping,Swansea,Uk
2951,2952,18/11/2019,BP,SAVE THE CHANGE,1.7,,4506.7,Savings,Swansea,Uk
2952,2953,18/11/2019,DEB,Brontosaurus Vegan,41.18,,4508.4,Dine Out,Swansea,Uk
2953,2954,18/11/2019,DEB,MARKS&SPENCER PLC,7.12,,4549.58,Clothes,,
2954,2955,18/11/2019,CPT,LNK M&S SWANSEA,40.0,,4556.7,Cash,Swansea,Uk
2955,2956,15/11/2019,FPO,AMELIA TERESZKIEWI,20.0,,4596.7,Services,Swansea,Uk
2956,2957,15/11/2019,CPT,LNK FULTON HOUSE,40.0,,4616.7,Cash,Swansea,Uk
2957,2958,15/11/2019,BGC,UNII OF BHAM INST,,115.6,4656.7,Supplementary Income,Swansea,Uk
2958,2959,14/11/2019,FPO,REMUS,27.37,,4541.1,Clothes,,
2959,2960,13/11/2019,CPT,LNK TESCO FABIAN W,50.0,,4568.47,Cash,Swansea,Uk
2960,2961,12/11/2019,BP,SAVE THE CHANGE,0.2,,4618.47,Savings,Swansea,Uk
2961,2962,11/11/2019,DEB,ANOKI LTD,50.8,,4618.67,Dine Out,Nottingham,Uk
2962,2963,11/11/2019,CPT,LNK 36 CLUMBER STR,40.0,,4669.47,Cash,Nottingham,Uk
2963,2964,07/11/2019,DD,THE GYM LTD,14.99,,4709.47,Fitness,Swansea,Uk
2964,2965,07/11/2019,BP,SAVE THE CHANGE,3.45,,4724.46,Savings,Swansea,Uk
2965,2966,06/11/2019,DEB,TFW RAIL SERVICES,138.25,,4727.91,Travel,,
2966,2967,06/11/2019,DEB,TESCO STORES 6213,25.6,,4866.16,Groceries,,
2967,2968,06/11/2019,DEB,UBER TRIP HELP.UBE,9.16,,4891.76,Travel,,
2968,2969,06/11/2019,DEB,UBER TRIP HELP.UBE,8.04,,4900.92,Travel,,
2969,2970,06/11/2019,DEB,UBER TRIP HELP.UBE,3.5,,4908.96,Travel,,
2970,2971,04/11/2019,DEP,CLUB LLOYDS WAIVED,,3.0,4912.46,Supplementary Income,Swansea,Uk
2971,2972,04/11/2019,PAY,CLUB LLOYDS FEE,3.0,,4909.46,Bills,Swansea,Uk
2972,2973,04/11/2019,BP,SAVE THE CHANGE,1.62,,4912.46,Savings,Swansea,Uk
2973,2974,04/11/2019,DEB,Brontosaurus Vegan,27.22,,4914.08,Dine Out,Swansea,Uk
2974,2975,04/11/2019,DEB,IZ *EZY VEGAN LTD,9.5,,4941.3,Dine Out,Nottingham,Uk
2975,2976,04/11/2019,CPT,LNK M&S SWANSEA,50.0,,4950.8,Cash,Swansea,Uk
2976,2977,04/11/2019,DEP,LOYD 802 OXFORD ST,,45.75,5000.8,Supplementary Income,Swansea,Uk
2977,2978,04/11/2019,CPT,LNK M&S SWANSEA,50.0,,4955.05,Cash,Swansea,Uk
2978,2979,01/11/2019,,INTEREST (GROSS),,4.78,5005.05,Interest,Swansea,Uk
2979,2980,01/11/2019,DEB,NON-GBP PURCH FEE,0.5,,5000.27,Others,Swansea,Uk
2980,2981,01/11/2019,DEB,NON-GBP TRANS FEE,1.27,,5000.77,Others,Swansea,Uk
2981,2982,01/11/2019,DEB,DELTA AIR   Baggag,42.66,,5002.04,Travel,,
2982,2983,01/11/2019,CPT,LNK TESCO FABIAN W,50.0,,5044.7,Cash,Swansea,Uk
2983,2984,01/11/2019,DD,SANTANDER MORTGAGE,959.09,,5094.7,Mortgage,Swansea,Uk
2984,2985,01/11/2019,DD,CC SWANSEA C.TAX,147.0,,6053.79,Bills,Swansea,Uk
2985,2986,01/11/2019,DD,GOOD ENERGY LTD,50.0,,6200.79,Bills,Swansea,Uk
2986,2987,01/11/2019,DD,DWR CYMRU W WATER,32.5,,6250.79,Bills,Swansea,Uk
2987,2988,01/11/2019,DD,ZURICH,24.82,,6283.29,Insurance,Swansea,Uk
2988,2989,01/11/2019,SO,ESAVINGS ACCOUNT,300.0,,6308.11,Savings,Swansea,Uk
2989,2990,31/10/2019,DD,UCU B ACCOUNT,24.76,,6608.11,Others,Swansea,Uk
2990,2991,31/10/2019,BP,SAVE THE CHANGE,0.81,,6632.87,Savings,Swansea,Uk
2991,2992,31/10/2019,BGC,SWANSEA UNI - PAY,,3289.12,6633.68,Paycheck,Swansea,Uk
2992,2993,30/10/2019,FPO,SALLY GOLDSTONE,550.0,,3344.56,Others,Swansea,Uk
2993,2994,30/10/2019,DEB,NON-GBP PURCH FEE,0.5,,3894.56,Others,Swansea,Uk
2994,2995,30/10/2019,DEB,NON-GBP TRANS FEE,33.1,,3895.06,Others,Swansea,Uk
2995,2996,30/10/2019,DEB,PINNACLE VANCOUVER,1107.19,,3928.16,Hotels,Vancouver,Canada
2996,2997,28/10/2019,DD,TALKTALK LIMITED,20.61,,5035.35,Bills,Swansea,Uk
2997,2998,28/10/2019,DEB,FOREIGN CASH FEE,1.5,,5055.96,Travel,,
2998,2999,28/10/2019,DEB,PROSPECT POINT BAR,68.98,,5057.46,Dine Out,Vancouver,Canada
2999,3000,25/10/2019,BP,SAVE THE CHANGE,0.01,,5126.44,Savings,Swansea,Uk
3000,3001,25/10/2019,BGC,SWANSEA UNIVERSITY,,923.05,5126.45,Supplementary Income,Swansea,Uk
3001,3002,24/10/2019,DEB,Audible.co.uk,7.99,,4203.4,Entertainment,Swansea,Uk
3002,3003,23/10/2019,DD,HARLANDS,25.0,,4211.39,Fitness,Swansea,Uk
3003,3004,23/10/2019,BP,SAVE THE CHANGE,0.67,,4236.39,Savings,Swansea,Uk
3004,3005,22/10/2019,DEB,NON-GBP PURCH FEE,0.5,,4237.06,Others,Swansea,Uk
3005,3006,22/10/2019,DEB,NON-GBP TRANS FEE,2.96,,4237.56,Others,Swansea,Uk
3006,3007,22/10/2019,DEB,RONSONS #102,99.33,,4240.52,Home Improvement,Swansea,Uk
3007,3008,22/10/2019,DD,CORGI HOMEPLAN,18.0,,4339.85,Home Improvement,Swansea,Uk
3008,3009,22/10/2019,BP,SAVE THE CHANGE,2.09,,4357.85,Savings,Swansea,Uk
3009,3010,21/10/2019,DEB,NON-GBP CASH FEE,1.5,,4359.94,Others,Swansea,Uk
3010,3011,21/10/2019,DEB,NON-GBP TRANS FEE,5.31,,4361.44,Others,Swansea,Uk
3011,3012,21/10/2019,DEB,*VANCOUVER CBC & M,177.86,,4366.75,Travel,Vancouver,Canada
3012,3013,21/10/2019,DEB,NON-GBP PURCH FEE,0.5,,4544.61,Others,Swansea,Uk
3013,3014,21/10/2019,DEB,NON-GBP TRANS FEE,4.68,,4545.11,Others,Swansea,Uk
3014,3015,21/10/2019,DEB,PINNACLE VANCOUVER,156.74,,4549.79,Hotels,Vancouver,Canada
3015,3016,21/10/2019,DEB,NON-GBP PURCH FEE,0.5,,4706.53,Others,Swansea,Uk
3016,3017,21/10/2019,DEB,NON-GBP TRANS FEE,0.25,,4707.03,Others,Swansea,Uk
3017,3018,21/10/2019,DEB,BLAZE PIZZA,8.5,,4707.28,Dine Out,,
3018,3019,21/10/2019,DEB,BREKA BAKERY & CAF,2.62,,4715.78,Dine Out,,
3019,3020,21/10/2019,DEB,NON-GBP PURCH FEE,0.5,,4718.4,Others,Swansea,Uk
3020,3021,21/10/2019,DEB,NON-GBP TRANS FEE,1.04,,4718.9,Others,Swansea,Uk
3021,3022,21/10/2019,DEB,AMTRAK  292795,35.05,,4719.94,Travel,,
3022,3023,21/10/2019,DEB,KLM UNITEDKI074823,43.0,,4754.99,Travel,,
3023,3024,21/10/2019,TFR,F/FLOW KING ABDULL,,216.93,4797.99,Supplementary Income,Swansea,Uk
3024,3025,21/10/2019,DD,VIRGIN MEDIA PYMTS,44.5,,4581.06,Bills,Swansea,Uk
3025,3026,21/10/2019,BP,SAVE THE CHANGE,3.49,,4625.56,Savings,Swansea,Uk
3026,3027,21/10/2019,DEB,NON-GBP PURCH FEE,0.5,,4629.05,Others,Swansea,Uk
3027,3028,21/10/2019,DEB,NON-GBP TRANS FEE,0.81,,4629.55,Others,Swansea,Uk
3028,3029,21/10/2019,DEB,OLD NAVY 4218,27.21,,4630.36,Clothes,,
3029,3030,21/10/2019,DEB,NON-GBP PURCH FEE,0.5,,4657.57,Others,Swansea,Uk
3030,3031,21/10/2019,DEB,NON-GBP TRANS FEE,0.55,,4658.07,Others,Swansea,Uk
3031,3032,21/10/2019,DEB,UBER   TRIP,18.52,,4658.62,Travel,,
3032,3033,21/10/2019,DEB,NON-GBP PURCH FEE,0.5,,4677.14,Others,Swansea,Uk
3033,3034,21/10/2019,DEB,NON-GBP TRANS FEE,1.32,,4677.64,Others,Swansea,Uk
3034,3035,21/10/2019,DEB,DHERGANE FARAH,44.4,,4678.96,Services,Swansea,Uk
3035,3036,21/10/2019,DEB,TFW RAIL SERVICES,50.4,,4723.36,Travel,,
3036,3037,21/10/2019,DEB,M&S SIMPLY FOOD SS,6.4,,4773.76,Groceries,Swansea,Uk
3037,3038,18/10/2019,DEB,AIRBNB * HMABB9424,705.58,,4780.16,Hotels,,
3038,3039,18/10/2019,BP,SAVE THE CHANGE,0.02,,5485.74,Savings,Swansea,Uk
3039,3040,17/10/2019,DEB,Audible.co.uk,18.0,,5485.76,Entertainment,Swansea,Uk
3040,3041,17/10/2019,DEB,AMZNMktplace,11.99,,5503.76,Amazon,Swansea,Uk
3041,3042,17/10/2019,DEB,AMZNMKTPLACE AMAZO,11.99,,5515.75,Amazon,Swansea,Uk
3042,3043,17/10/2019,BP,SAVE THE CHANGE,0.23,,5527.74,Savings,Swansea,Uk
3043,3044,16/10/2019,DEB,TURKISH LTD 311058,12.77,,5527.97,Travel,,
3044,3045,16/10/2019,CHQ,54,35.0,,5540.74,Cash,,
3045,3046,16/10/2019,DD,O2,18.39,,5575.74,Other Shopping,Swansea,Uk
3046,3047,16/10/2019,BP,SAVE THE CHANGE,0.2,,5594.13,Savings,Swansea,Uk
3047,3048,15/10/2019,DEB,AMZNMktplace,6.8,,5594.33,Amazon,Swansea,Uk
3048,3049,15/10/2019,CPT,LNK TESCO FABIAN W,50.0,,5601.13,Cash,Swansea,Uk
3049,3050,14/10/2019,BP,SAVE THE CHANGE,1.15,,5651.13,Savings,Swansea,Uk
3050,3051,14/10/2019,DEB,Brontosaurus Vegan,14.35,,5652.28,Dine Out,Swansea,Uk
3051,3052,14/10/2019,DEB,MARKS&SPENCER PLC,4.7,,5666.63,Clothes,,
3052,3053,14/10/2019,CPT,LNK M&S SWANSEA,50.0,,5671.33,Cash,Swansea,Uk
3053,3054,11/10/2019,DEB,TFW RAIL SERVICES,103.8,,5721.33,Travel,,
3054,3055,10/10/2019,BP,SAVE THE CHANGE,0.11,,5825.13,Savings,Swansea,Uk
3055,3056,09/10/2019,DEB,Amazon.co.uk*MO5VX,7.89,,5825.24,Amazon,Swansea,Uk
3056,3057,09/10/2019,CPT,LNK TESCO FABIAN W,50.0,,5833.13,Cash,Swansea,Uk
3057,3058,08/10/2019,BP,SAVE THE CHANGE,0.08,,5883.13,Savings,Swansea,Uk
3058,3059,07/10/2019,DEB,AMZNMktplace,8.92,,5883.21,Amazon,Swansea,Uk
3059,3060,07/10/2019,DD,HARLANDS,25.0,,5892.13,Fitness,Swansea,Uk
3060,3061,07/10/2019,DD,THE GYM LTD,14.99,,5917.13,Fitness,Swansea,Uk
3061,3062,07/10/2019,BP,SAVE THE CHANGE,1.54,,5932.12,Savings,Swansea,Uk
3062,3063,07/10/2019,DEB,WILKO RETAIL LIMIT,21.25,,5933.66,Other Shopping,,
3063,3064,07/10/2019,DEB,MARKS&SPENCER PLC,11.71,,5954.91,Clothes,,
3064,3065,07/10/2019,DEB,SAINSBURYS S/MKTS,13.5,,5966.62,Groceries,,
3065,3066,07/10/2019,FPO,AMELIA TERESZKIEWI,20.0,,5980.12,Services,Swansea,Uk
3066,3067,04/10/2019,DEB,TESCO STORES 4628,5.0,,6000.12,Groceries,,
3067,3068,04/10/2019,CPT,LNK TESCO FABIAN W,40.0,,6005.12,Cash,Swansea,Uk
3068,3069,03/10/2019,DEB,THE BIKE HUB,30.0,,6045.12,Other Shopping,,
3069,3070,02/10/2019,DEP,CLUB LLOYDS WAIVED,,3.0,6075.12,Supplementary Income,Swansea,Uk
3070,3071,02/10/2019,PAY,CLUB LLOYDS FEE,3.0,,6072.12,Bills,Swansea,Uk
3071,3072,02/10/2019,CPT,LNK SWANSEA CITY C,50.0,,6075.12,Cash,Swansea,Uk
3072,3073,02/10/2019,BP,SAVE THE CHANGE,0.2,,6125.12,Savings,Swansea,Uk
3073,3074,01/10/2019,,INTEREST (GROSS),,5.78,6125.32,Interest,Swansea,Uk
3074,3075,01/10/2019,DEB,PETER ALAN RESIDEN,178.8,,6119.54,Rent,Swansea,Uk
3075,3076,01/10/2019,DD,SANTANDER MORTGAGE,959.09,,6298.34,Mortgage,Swansea,Uk
3076,3077,01/10/2019,DD,CC SWANSEA C.TAX,147.0,,7257.43,Bills,Swansea,Uk
3077,3078,01/10/2019,DD,GOOD ENERGY LTD,50.0,,7404.43,Bills,Swansea,Uk
3078,3079,01/10/2019,DD,DWR CYMRU W WATER,32.5,,7454.43,Bills,Swansea,Uk
3079,3080,01/10/2019,DD,ZURICH,24.82,,7486.93,Insurance,Swansea,Uk
3080,3081,01/10/2019,SO,ESAVINGS ACCOUNT,300.0,,7511.75,Savings,Swansea,Uk
3081,3082,30/09/2019,DD,UCU B ACCOUNT,24.76,,7811.75,Others,Swansea,Uk
3082,3083,30/09/2019,BP,SAVE THE CHANGE,2.48,,7836.51,Savings,Swansea,Uk
3083,3084,30/09/2019,BGC,SWANSEA UNI - PAY,,3311.76,7838.99,Paycheck,Swansea,Uk
3084,3085,30/09/2019,DEB,Brontosaurus Vegan,21.77,,4527.23,Dine Out,Swansea,Uk
3085,3086,30/09/2019,DEB,MARKS&SPENCER PLC,7.1,,4549.0,Clothes,,
3086,3087,30/09/2019,DEB,SAINSBURYS S/MKTS,22.5,,4556.1,Groceries,,
3087,3088,30/09/2019,CPT,LNK M&S SWANSEA,50.0,,4578.6,Cash,Swansea,Uk
3088,3089,27/09/2019,DEB,TURKISH LTD 311058,13.15,,4628.6,Travel,,
3089,3090,27/09/2019,CPT,LNK TESCO FABIAN W,30.0,,4641.75,Cash,Swansea,Uk
3090,3091,25/09/2019,CPT,LNK TESCO FABIAN W,50.0,,4671.75,Cash,Swansea,Uk
3091,3092,25/09/2019,BP,SAVE THE CHANGE,0.01,,4721.75,Savings,Swansea,Uk
3092,3093,24/09/2019,DEB,Audible.co.uk,7.99,,4721.76,Entertainment,Swansea,Uk
3093,3094,24/09/2019,BP,SAVE THE CHANGE,0.3,,4729.75,Savings,Swansea,Uk
3094,3095,23/09/2019,DEB,Audible.co.uk,18.0,,4730.05,Entertainment,Swansea,Uk
3095,3096,23/09/2019,DEB,MARKS&SPENCER PLC,4.7,,4748.05,Clothes,,
3096,3097,23/09/2019,DEB,URBANZENINSTRUCTOR,7.0,,4752.75,Services,Swansea,Uk
3097,3098,23/09/2019,CHQ,53,500.0,,4759.75,Cash,,
3098,3099,23/09/2019,DD,VIRGIN MEDIA PYMTS,36.8,,5259.75,Bills,Swansea,Uk
3099,3100,23/09/2019,DD,CORGI HOMEPLAN,14.75,,5296.55,Home Improvement,Swansea,Uk
3100,3101,23/09/2019,BP,SAVE THE CHANGE,0.63,,5311.3,Savings,Swansea,Uk
3101,3102,23/09/2019,DEB,Brontosaurus Vegan,10.79,,5311.93,Dine Out,Swansea,Uk
3102,3103,23/09/2019,CPT,LNK PO THE CITYOFS,50.0,,5322.72,Cash,,
3103,3104,20/09/2019,DEB,AMZNMktplace,30.58,,5372.72,Amazon,Swansea,Uk
3104,3105,20/09/2019,BP,SAVE THE CHANGE,0.25,,5403.3,Savings,Swansea,Uk
3105,3106,20/09/2019,BGC,UNIV OF NOTTINGHAM,,186.29,5403.55,Paycheck,Nottingham,Uk
3106,3107,19/09/2019,DEB,NON-GBP PURCH FEE,0.5,,5217.26,Others,Swansea,Uk
3107,3108,19/09/2019,DEB,NON-GBP TRANS FEE,1.36,,5217.76,Others,Swansea,Uk
3108,3109,19/09/2019,DEB,NAME-CHEAP.COM,45.75,,5219.12,Purchase of uk.eg.org,Swansea,Uk
3109,3110,19/09/2019,BP,SAVE THE CHANGE,0.05,,5264.87,Savings,Swansea,Uk
3110,3111,18/09/2019,DEB,WWW.FREEDOM-LEISUR,5.95,,5264.92,Entertainment,Worcester,Uk
3111,3112,17/09/2019,DEB,ODEON UPT,10.0,,5270.87,Entertainment,,
3112,3113,17/09/2019,TFR,F/FLOW AARHUS UNIV,,250.31,5280.87,Supplementary Income,Swansea,Uk
3113,3114,16/09/2019,CPT,LNK TESCO FABIAN W,50.0,,5030.56,Cash,Swansea,Uk
3114,3115,16/09/2019,DD,O2,23.38,,5080.56,Other Shopping,Swansea,Uk
3115,3116,16/09/2019,BP,SAVE THE CHANGE,1.76,,5103.94,Savings,Swansea,Uk
3116,3117,16/09/2019,DEB,Brontosaurus Vegan,13.28,,5105.7,Dine Out,Swansea,Uk
3117,3118,16/09/2019,DEB,SPORTSDIRECT 141,41.99,,5118.98,Other Shopping,,
3118,3119,16/09/2019,DEB,Brontosaurus Vegan,13.04,,5160.97,Dine Out,Swansea,Uk
3119,3120,13/09/2019,DEB,AMZNMktplace,9.99,,5174.01,Amazon,Swansea,Uk
3120,3121,13/09/2019,DEB,AMZNMKTPLACE AMAZO,9.99,,5184.0,Amazon,Swansea,Uk
3121,3122,13/09/2019,DEB,WWW.FREEDOM-LEISUR,5.95,,5193.99,Entertainment,Worcester,Uk
3122,3123,13/09/2019,CPT,LOYD LOYD 802 OXFO,80.0,,5199.94,Cash,Swansea,Uk
3123,3124,13/09/2019,BP,SAVE THE CHANGE,0.45,,5279.94,Savings,Swansea,Uk
3124,3125,12/09/2019,DEB,SAINSBURYS S/MKTS,28.55,,5280.39,Groceries,,
3125,3126,12/09/2019,BP,SAVE THE CHANGE,0.1,,5308.94,Savings,Swansea,Uk
3126,3127,11/09/2019,DEB,WWW.FREEDOM-LEISUR,5.95,,5309.04,Entertainment,Worcester,Uk
3127,3128,11/09/2019,DEB,Amazon.co.uk*MA0PV,0.95,,5314.99,Amazon,Swansea,Uk
3128,3129,11/09/2019,BP,SAVE THE CHANGE,0.9,,5315.94,Savings,Swansea,Uk
3129,3130,10/09/2019,DEB,TESCO STORES 5957,6.1,,5316.84,Groceries,,
3130,3131,10/09/2019,CPT,LNK TESCO FABIAN W,50.0,,5322.94,Cash,Swansea,Uk
3131,3132,10/09/2019,BP,SAVE THE CHANGE,1.34,,5372.94,Savings,Swansea,Uk
3132,3133,09/09/2019,DEB,ORCHARD HOTEL,89.0,,5374.28,Hotels,Nottingham,Uk
3133,3134,09/09/2019,DEB,TFW RAIL SERVICES,84.2,,5463.28,Travel,,
3134,3135,09/09/2019,DEB,AMZNMktplace,9.97,,5547.48,Amazon,Swansea,Uk
3135,3136,09/09/2019,DEB,WH SMITH,6.49,,5557.45,Other Shopping,,
3136,3137,09/09/2019,DEB,POUNDLAND LTD 1414,4.0,,5563.94,Groceries,,
3137,3138,09/09/2019,DEB,Audible.co.uk,18.0,,5567.94,Entertainment,Swansea,Uk
3138,3139,09/09/2019,DD,THE GYM LTD,14.99,,5585.94,Fitness,Swansea,Uk
3139,3140,09/09/2019,BP,SAVE THE CHANGE,0.51,,5600.93,Savings,Swansea,Uk
3140,3141,09/09/2019,DEB,MARKS&SPENCER PLC,12.5,,5601.44,Clothes,,
3141,3142,09/09/2019,DEB,MARKS&SPENCER PLC,11.0,,5613.94,Clothes,,
3142,3143,09/09/2019,CPT,LNK M&S SWANSEA,50.0,,5624.94,Cash,Swansea,Uk
3143,3144,06/09/2019,DEB,AMZNMKTPLACE AMAZO,10.99,,5674.94,Amazon,Swansea,Uk
3144,3145,06/09/2019,CPT,LNK TESCO FABIAN W,50.0,,5685.93,Cash,Swansea,Uk
3145,3146,05/09/2019,BP,SAVE THE CHANGE,0.75,,5735.93,Savings,Swansea,Uk
3146,3147,04/09/2019,DEB,SAINSBURYS S/MKTS,13.55,,5736.68,Groceries,,
3147,3148,04/09/2019,DEB,WWW.FREEDOM-LEISUR,5.95,,5750.23,Entertainment,Worcester,Uk
3148,3149,04/09/2019,DEB,AMZNMktplace,2.75,,5756.18,Amazon,Swansea,Uk
3149,3150,04/09/2019,CPT,LNK TESCO FABIAN W,50.0,,5758.93,Cash,Swansea,Uk
3150,3151,04/09/2019,BP,SAVE THE CHANGE,0.19,,5808.93,Savings,Swansea,Uk
3151,3152,03/09/2019,DEP,CLUB LLOYDS WAIVED,,3.0,5809.12,Supplementary Income,Swansea,Uk
3152,3153,03/09/2019,PAY,CLUB LLOYDS FEE,3.0,,5806.12,Bills,Swansea,Uk
3153,3154,03/09/2019,DEB,WWW.III.CO.UK DE,1000.0,,5809.12,Investment,Swansea,Uk
3154,3155,03/09/2019,DEB,AMZNMktplace,2.81,,6809.12,Amazon,Swansea,Uk
3155,3156,03/09/2019,BP,SAVE THE CHANGE,0.4,,6811.93,Savings,Swansea,Uk
3156,3157,02/09/2019,,INTEREST (GROSS),,6.53,6812.33,Interest,Swansea,Uk
3157,3158,02/09/2019,FPI,E JAKUBOWSKA,,15.0,6805.8,Supplementary Income,Swansea,Uk
3158,3159,02/09/2019,DEB,M&S SIMPLY FOOD SS,9.6,,6790.8,Groceries,Swansea,Uk
3159,3160,02/09/2019,DD,SANTANDER MORTGAGE,1018.45,,6800.4,Mortgage,Swansea,Uk
3160,3161,02/09/2019,DD,CC SWANSEA C.TAX,147.0,,7818.85,Bills,Swansea,Uk
3161,3162,02/09/2019,DD,GOOD ENERGY LTD,50.0,,7965.85,Bills,Swansea,Uk
3162,3163,02/09/2019,DD,DWR CYMRU W WATER,32.5,,8015.85,Bills,Swansea,Uk
3163,3164,02/09/2019,DD,ZURICH,20.69,,8048.35,Insurance,Swansea,Uk
3164,3165,02/09/2019,SO,ESAVINGS ACCOUNT,300.0,,8069.04,Savings,Swansea,Uk
3165,3166,30/08/2019,DD,UCU B ACCOUNT,24.26,,8369.04,Others,Swansea,Uk
3166,3167,30/08/2019,BGC,SWANSEA UNI - PAY,,3311.76,8393.3,Paycheck,Swansea,Uk
3167,3168,28/08/2019,DEB,FOREIGN CASH FEE,1.5,,5081.54,Travel,,
3168,3169,28/08/2019,DEB,CALLE CATALUNA 4,207.55,,5083.04,Travel,Madrid,Spain
3169,3170,28/08/2019,DEB,REVOLUT*7996*,10.0,,5290.59,Dine Out,,
3170,3171,27/08/2019,BP,SAVE THE CHANGE,3.08,,5300.59,Savings,Swansea,Uk
3171,3172,27/08/2019,DEB,NON-GBP PURCH FEE,0.5,,5303.67,Others,Swansea,Uk
3172,3173,27/08/2019,DEB,NON-GBP TRANS FEE,8.51,,5304.17,Others,Swansea,Uk
3173,3174,27/08/2019,DEB,AMISTAT ISLAND HOS,284.75,,5312.68,Hotels,Illes balears,Spain
3174,3175,27/08/2019,DEB,WWW.III.CO.UK DE,500.0,,5597.43,Investment,Nottingham,Uk
3175,3176,27/08/2019,DEB,WWW.III.CO.UK DE,500.0,,6097.43,Investment,Nottingham,Uk
3176,3177,27/08/2019,DEB,TFW RAIL SERVICES,50.4,,6597.43,Travel,,
3177,3178,27/08/2019,DEB,BRS WDF MAIN,20.83,,6647.83,Other Shopping,Bristol,Uk
3178,3179,27/08/2019,DEB,M&S SIMPLY FOOD SS,8.0,,6668.66,Groceries,Swansea,Uk
3179,3180,27/08/2019,DEB,STARBUCKS COFFEE C,4.05,,6676.66,Dine Out,,
3180,3181,27/08/2019,DEB,Audible.co.uk,7.99,,6680.71,Entertainment,Swansea,Uk
3181,3182,27/08/2019,DEB,SWANSEA UNI - CATE,4.65,,6688.7,Dine Out,Swansea,Uk
3182,3183,27/08/2019,TFR,R LAWRENCE  24AUG19,,500.0,6693.35,Supplementary Income,Swansea,Uk
3183,3184,23/08/2019,DEB,ZINCO LOUNGE,21.25,,6193.35,Dine Out,Swansea,Uk
3184,3185,23/08/2019,CPT,LNK FABIAN WAY,50.0,,6214.6,Cash,Swansea,Uk
3185,3186,22/08/2019,DD,CORGI HOMEPLAN,14.75,,6264.6,Home Improvement,Swansea,Uk
3186,3187,22/08/2019,BP,SAVE THE CHANGE,0.05,,6279.35,Savings,Swansea,Uk
3187,3188,21/08/2019,DEB,WWW.FREEDOM-LEISUR,5.95,,6279.4,Entertainment,Worcester,Uk
3188,3189,21/08/2019,DEB,URBANZENINSTRUCTOR,7.0,,6285.35,Services,Swansea,Uk
3189,3190,21/08/2019,CPT,LNK M&S SWANSEA,60.0,,6292.35,Cash,Swansea,Uk
3190,3191,21/08/2019,DD,VIRGIN MEDIA PYMTS,29.0,,6352.35,Bills,Swansea,Uk
3191,3192,21/08/2019,BP,SAVE THE CHANGE,0.54,,6381.35,Savings,Swansea,Uk
3192,3193,20/08/2019,DEB,AMZNMktplace,19.97,,6381.89,Amazon,Swansea,Uk
3193,3194,20/08/2019,DEB,AMZNMKTPLACE AMAZO,12.99,,6401.86,Amazon,Swansea,Uk
3194,3195,20/08/2019,DEB,TESCO STORES 4628,6.5,,6414.85,Groceries,,
3195,3196,20/08/2019,BP,SAVE THE CHANGE,1.11,,6421.35,Savings,Swansea,Uk
3196,3197,19/08/2019,DEB,WWW.III.CO.UK DE,900.0,,6422.46,Investment,Nottingham,Uk
3197,3198,19/08/2019,DEB,Audible.co.uk,4.41,,7322.46,Entertainment,Swansea,Uk
3198,3199,19/08/2019,DEB,SCANDIC AARHUS CIT,21.48,,7326.87,Travel,Aarhus,Denmark
3199,3200,19/08/2019,BP,SAVE THE CHANGE,5.74,,7348.35,Savings,Swansea,Uk
3200,3201,19/08/2019,CPT,LNK 90146901 SA1 G,40.0,,7354.09,Cash,,
3201,3202,19/08/2019,DEB,NON-GBP PURCH FEE,0.5,,7394.09,Others,Swansea,Uk
3202,3203,19/08/2019,DEB,NON-GBP TRANS FEE,1.63,,7394.59,Others,Swansea,Uk
3203,3204,19/08/2019,DEB,AMISTATISLANDHOSTE,54.72,,7396.22,Hotels,Illes balears,Spain
3204,3205,19/08/2019,DEB,NON-GBP PURCH FEE,0.5,,7450.94,Others,Swansea,Uk
3205,3206,19/08/2019,DEB,NON-GBP TRANS FEE,1.15,,7451.44,Others,Swansea,Uk
3206,3207,19/08/2019,DEB,MIB AARHUS LUFTHAV,38.72,,7452.59,Dine Out,Aarhus,Denmark
3207,3208,19/08/2019,DEB,NON-GBP PURCH FEE,0.5,,7491.31,Others,Swansea,Uk
3208,3209,19/08/2019,DEB,NON-GBP TRANS FEE,0.42,,7491.81,Others,Swansea,Uk
3209,3210,19/08/2019,DEB,MIDTTRAFIK,14.18,,7492.23,Travel,,
3210,3211,19/08/2019,DEB,NON-GBP PURCH FEE,0.5,,7506.41,Others,Swansea,Uk
3211,3212,19/08/2019,DEB,NON-GBP TRANS FEE,0.33,,7506.91,Others,Swansea,Uk
3212,3213,19/08/2019,DEB,MIB AARHUS LUFTHAV,11.1,,7507.24,Dine Out,Aarhus,Denmark
3213,3214,19/08/2019,DEB,NON-GBP PURCH FEE,0.5,,7518.34,Others,Swansea,Uk
3214,3215,19/08/2019,DEB,NON-GBP TRANS FEE,0.53,,7518.84,Others,Swansea,Uk
3215,3216,19/08/2019,DEB,TAXAS KUNDECENTER,18.01,,7519.37,Services,Swansea,Uk
3216,3217,19/08/2019,DEB,NON-GBP PURCH FEE,0.5,,7537.38,Others,Swansea,Uk
3217,3218,19/08/2019,DEB,NON-GBP TRANS FEE,0.4,,7537.88,Others,Swansea,Uk
3218,3219,19/08/2019,DEB,SHAKSHUKA,13.57,,7538.28,Dine Out,,
3219,3220,19/08/2019,DEB,NON-GBP PURCH FEE,0.5,,7551.85,Others,Swansea,Uk
3220,3221,19/08/2019,DEB,NON-GBP TRANS FEE,0.19,,7552.35,Others,Swansea,Uk
3221,3222,19/08/2019,DEB,DEEDEES ApS,6.41,,7552.54,Dine Out,Aarhus,Denmark
3222,3223,16/08/2019,DEB,NON-GBP PURCH FEE,0.5,,7558.95,Others,Swansea,Uk
3223,3224,16/08/2019,DEB,NON-GBP TRANS FEE,0.42,,7559.45,Others,Swansea,Uk
3224,3225,16/08/2019,DEB,MIDTTRAFIK,14.26,,7559.87,Travel,,
3225,3226,16/08/2019,DEB,RADISSON BLU HOTEL,114.3,,7574.13,Hotels,Leeds,Uk
3226,3227,16/08/2019,DEB,AMZNMKTPLACE AMAZO,5.99,,7688.43,Amazon,Swansea,Uk
3227,3228,16/08/2019,DD,O2,23.38,,7694.42,Other Shopping,Swansea,Uk
3228,3229,16/08/2019,BP,SAVE THE CHANGE,1.22,,7717.8,Savings,Swansea,Uk
3229,3230,16/08/2019,BGC,SWANSEA UNIVERSITY,,1695.55,7719.02,Supplementary Income,Swansea,Uk
3230,3231,15/08/2019,DEB,TFW RAIL SERVICES,97.1,,6023.47,Travel,,
3231,3232,15/08/2019,DEB,Brontosaurus Vegan,12.99,,6120.57,Dine Out,Swansea,Uk
3232,3233,15/08/2019,DEB,RYANAIR   224000,28.69,,6133.56,Travel,,
3233,3234,15/08/2019,BP,SAVE THE CHANGE,0.01,,6162.25,Savings,Swansea,Uk
3234,3235,14/08/2019,DEB,RYANAIR   224000,29.0,,6162.26,Travel,,
3235,3236,14/08/2019,DEB,AMZNMktplace,16.99,,6191.26,Amazon,Swansea,Uk
3236,3237,14/08/2019,BP,SAVE THE CHANGE,0.11,,6208.25,Savings,Swansea,Uk
3237,3238,13/08/2019,DEB,WWW.III.CO.UK DE,1100.0,,6208.36,Investment,Nottingham,Uk
3238,3239,13/08/2019,DEB,SAINSBURYS S/MKTS,16.9,,7308.36,Groceries,,
3239,3240,13/08/2019,DEB,AMZNMktplace,9.99,,7325.26,Amazon,Swansea,Uk
3240,3241,13/08/2019,CPT,LNK TESCO FABIAN W,60.0,,7335.25,Cash,Swansea,Uk
3241,3242,13/08/2019,BP,SAVE THE CHANGE,0.45,,7395.25,Savings,Swansea,Uk
3242,3243,12/08/2019,TFR,R LAWRENCE,,1100.0,7395.7,Supplementary Income,Swansea,Uk
3243,3244,12/08/2019,DEB,COFFEE#1 SWANSEA,8.55,,6295.7,Dine Out,Swansea,Uk
3244,3245,12/08/2019,BP,SAVE THE CHANGE,4.55,,6304.25,Savings,Swansea,Uk
3245,3246,12/08/2019,DEB,COFFEE#1 SWANSEA,11.85,,6308.8,Dine Out,Swansea,Uk
3246,3247,12/08/2019,DEB,VALLEY MILL LTD,10.95,,6320.65,Other Shopping,,
3247,3248,12/08/2019,DEB,MARKS&SPENCER PLC,9.7,,6331.6,Clothes,,
3248,3249,12/08/2019,DEB,WILKO RETAIL LIMIT,8.0,,6341.3,Other Shopping,,
3249,3250,12/08/2019,DEB,WILKO RETAIL LIMIT,6.5,,6349.3,Other Shopping,,
3250,3251,12/08/2019,FPO,AMELIA TERESZKIEWI,35.0,,6355.8,Services,Swansea,Uk
3251,3252,12/08/2019,DEB,NON-GBP PURCH FEE,0.5,,6390.8,Others,Swansea,Uk
3252,3253,12/08/2019,DEB,NON-GBP TRANS FEE,0.19,,6391.3,Others,Swansea,Uk
3253,3254,12/08/2019,DEB,HMSHOST AMSTERDAM,6.52,,6391.49,Dine Out,Amsterdam,Netherlands
3254,3255,12/08/2019,DEB,ZINCO LOUNGE,12.45,,6398.01,Dine Out,Swansea,Uk
3255,3256,12/08/2019,DEB,AMZNMktplace,3.26,,6410.46,Amazon,Swansea,Uk
3256,3257,12/08/2019,DEB,AMZNMktplace,2.97,,6413.72,Amazon,Swansea,Uk
3257,3258,12/08/2019,DEB,AMZNMKTPLACE AMAZO,66.94,,6416.69,Amazon,Swansea,Uk
3258,3259,12/08/2019,CPT,LNK SWANSEA CITY C,50.0,,6483.63,Cash,Swansea,Uk
3259,3260,12/08/2019,DEB,NON-GBP PURCH FEE,0.5,,6533.63,Others,Swansea,Uk
3260,3261,12/08/2019,DEB,NON-GBP TRANS FEE,1.38,,6534.13,Others,Swansea,Uk
3261,3262,12/08/2019,DEB,DELTA AIR   Baggag,46.3,,6535.51,Travel,,
3262,3263,09/08/2019,CPT,LNK TESCO FABIAN W,60.0,,6581.81,Cash,Swansea,Uk
3263,3264,09/08/2019,DEB,NON-GBP PURCH FEE,0.5,,6641.81,Others,Swansea,Uk
3264,3265,09/08/2019,DEB,NON-GBP TRANS FEE,1.4,,6642.31,Others,Swansea,Uk
3265,3266,09/08/2019,DEB,NEWSLINK 16 BOS,47.01,,6643.71,Other Shopping,Boston,Usa
3266,3267,08/08/2019,DEB,WWW.III.CO.UK DE,100.0,,6690.72,Investment,Swansea,Uk
3267,3268,07/08/2019,DD,THE GYM LTD,14.99,,6790.72,Fitness,Swansea,Uk
3268,3269,07/08/2019,BP,SAVE THE CHANGE,0.53,,6805.71,Savings,Swansea,Uk
3269,3270,06/08/2019,DEB,WWW.III.CO.UK DE,1000.0,,6806.24,Investment,Swansea,Uk
3270,3271,06/08/2019,DEB,NON-GBP PURCH FEE,0.5,,7806.24,Others,Swansea,Uk
3271,3272,06/08/2019,DEB,NON-GBP TRANS FEE,1.06,,7806.74,Others,Swansea,Uk
3272,3273,06/08/2019,DEB,WHOLEFDS BLH 10091,35.47,,7807.8,Groceries,,
3273,3274,05/08/2019,BP,SAVE THE CHANGE,0.44,,7843.27,Savings,Swansea,Uk
3274,3275,05/08/2019,DEB,NON-GBP PURCH FEE,0.5,,7843.71,Others,Swansea,Uk
3275,3276,05/08/2019,DEB,NON-GBP TRANS FEE,1.16,,7844.21,Others,Swansea,Uk
3276,3277,05/08/2019,DEB,SHAWS #0677,38.88,,7845.37,Services,Swansea,Uk
3277,3278,02/08/2019,DEP,CLUB LLOYDS WAIVED,,3.0,7884.25,Supplementary Income,Swansea,Uk
3278,3279,02/08/2019,PAY,CLUB LLOYDS FEE,3.0,,7881.25,Bills,Swansea,Uk
3279,3280,02/08/2019,DEB,NON-GBP PURCH FEE,0.5,,7884.25,Others,Swansea,Uk
3280,3281,02/08/2019,DEB,NON-GBP TRANS FEE,0.7,,7884.75,Others,Swansea,Uk
3281,3282,02/08/2019,DEB,SAVERS - 1207,23.68,,7885.45,Other Shopping,,
3282,3283,02/08/2019,BP,SAVE THE CHANGE,0.04,,7909.13,Savings,Swansea,Uk
3283,3284,01/08/2019,,INTEREST (GROSS),,5.53,7909.17,Interest,Swansea,Uk
3284,3285,01/08/2019,DD,CC SWANSEA C.TAX,147.0,,7903.64,Bills,Swansea,Uk
3285,3286,01/08/2019,DD,GOOD ENERGY LTD,50.0,,8050.64,Bills,Swansea,Uk
3286,3287,01/08/2019,DD,DWR CYMRU W WATER,32.5,,8100.64,Bills,Swansea,Uk
3287,3288,01/08/2019,DD,ZURICH,20.69,,8133.14,Insurance,Swansea,Uk
3288,3289,01/08/2019,DEB,NON-GBP PURCH FEE,0.5,,8153.83,Others,Swansea,Uk
3289,3290,01/08/2019,DEB,NON-GBP TRANS FEE,0.98,,8154.33,Others,Swansea,Uk
3290,3291,01/08/2019,DEB,GAP US 822,32.96,,8155.31,Clothes,,
3291,3292,01/08/2019,SO,ESAVINGS ACCOUNT,300.0,,8188.27,Savings,Swansea,Uk
3292,3293,01/08/2019,BP,SAVE THE CHANGE,0.75,,8488.27,Savings,Swansea,Uk
3293,3294,31/07/2019,DEB,DOUBLETREE BY HILT,101.25,,8489.02,Hotels,,
3294,3295,31/07/2019,DD,UCU B ACCOUNT,24.26,,8590.27,Others,Swansea,Uk
3295,3296,31/07/2019,BP,SAVE THE CHANGE,0.6,,8614.53,Savings,Swansea,Uk
3296,3297,31/07/2019,BGC,SWANSEA UNI - PAY,,3265.85,8615.13,Paycheck,Swansea,Uk
3297,3298,30/07/2019,DEB,NON-GBP CASH FEE,1.5,,5349.28,Others,Swansea,Uk
3298,3299,30/07/2019,DEB,NON-GBP TRANS FEE,4.97,,5350.78,Others,Swansea,Uk
3299,3300,30/07/2019,DEB,*EASTERN AVENUE RE,166.24,,5355.75,Home Improvement,Swansea,Uk
3300,3301,30/07/2019,DEB,TFW RAIL SERVICES,50.4,,5521.99,Travel,,
3301,3302,30/07/2019,BP,SAVE THE CHANGE,0.99,,5572.39,Savings,Swansea,Uk
3302,3303,29/07/2019,DEB,Brontosaurus Vegan,15.52,,5573.38,Dine Out,Swansea,Uk
3303,3304,29/07/2019,DEB,AMZNMktplace,199.49,,5588.9,Amazon,Swansea,Uk
3304,3305,29/07/2019,DEB,URBANZENINSTRUCTOR,7.0,,5788.39,Services,Swansea,Uk
3305,3306,29/07/2019,CPT,LOYD LOYD 802 OXFO,50.0,,5795.39,Cash,Swansea,Uk
3306,3307,26/07/2019,BP,SAVE THE CHANGE,1.61,,5845.39,Savings,Swansea,Uk
3307,3308,26/07/2019,BGC,SWANSEA UNIVERSITY,,38.31,5847.0,Supplementary Income,Swansea,Uk
3308,3309,25/07/2019,DEB,NON-GBP PURCH FEE,0.5,,5808.69,Others,Swansea,Uk
3309,3310,25/07/2019,DEB,NON-GBP TRANS FEE,0.69,,5809.19,Others,Swansea,Uk
3310,3311,25/07/2019,DEB,ASKCRAIG,23.34,,5809.88,Entertainment,,
3311,3312,25/07/2019,DEB,RYANAIR   224000,49.97,,5833.22,Travel,,
3312,3313,25/07/2019,DEB,NON-GBP PURCH FEE,0.5,,5883.19,Others,Swansea,Uk
3313,3314,25/07/2019,DEB,NON-GBP TRANS FEE,0.83,,5883.69,Others,Swansea,Uk
3314,3315,25/07/2019,DEB,RYANAIR   000000,28.08,,5884.52,Travel,,
3315,3316,25/07/2019,CPT,LNK TESCO FABIAN W,100.0,,5912.6,Cash,Swansea,Uk
3316,3317,25/07/2019,BP,SAVE THE CHANGE,0.01,,6012.6,Savings,Swansea,Uk
3317,3318,24/07/2019,DEB,Audible.co.uk,7.99,,6012.61,Entertainment,Swansea,Uk
3318,3319,23/07/2019,BP,SAVE THE CHANGE,0.57,,6020.6,Savings,Swansea,Uk
3319,3320,22/07/2019,DEB,T K MAXX,48.93,,6021.17,Other Shopping,,
3320,3321,22/07/2019,DEB,AMZNMktplace,6.5,,6070.1,Amazon,Swansea,Uk
3321,3322,22/07/2019,DEB,URBANZENINSTRUCTOR,7.0,,6076.6,Services,Swansea,Uk
3322,3323,22/07/2019,TFR,F/FLOW GRINDEYS LL,,1069.68,6083.6,Supplementary Income,Swansea,Uk
3323,3324,22/07/2019,DD,VIRGIN MEDIA PYMTS,29.0,,5013.92,Bills,Swansea,Uk
3324,3325,22/07/2019,DD,CORGI HOMEPLAN,14.75,,5042.92,Home Improvement,Swansea,Uk
3325,3326,19/07/2019,FPO,AMELIA TERESZKIEWI,20.0,,5057.67,Services,Swansea,Uk
3326,3327,19/07/2019,CPT,LNK TESCO FABIAN W,50.0,,5077.67,Cash,Swansea,Uk
3327,3328,19/07/2019,BGC,SWANSEA UNIVERSITY,,1868.98,5127.67,Supplementary Income,Swansea,Uk
3328,3329,18/07/2019,BP,SAVE THE CHANGE,0.7,,3258.69,Savings,Swansea,Uk
3329,3330,17/07/2019,DEB,SAINSBURYS S/MKTS,10.3,,3259.39,Groceries,,
3330,3331,17/07/2019,BP,SAVE THE CHANGE,0.8,,3269.69,Savings,Swansea,Uk
3331,3332,16/07/2019,FPO,CARL DAVENPORT,60.0,,3270.49,Entertainment,Swansea,Uk
3332,3333,16/07/2019,DEB,AMAZON.CO.UK*MH023,36.2,,3330.49,Amazon,Swansea,Uk
3333,3334,16/07/2019,DD,O2,18.45,,3366.69,Other Shopping,Swansea,Uk
3334,3335,16/07/2019,BP,SAVE THE CHANGE,2.54,,3385.14,Savings,Swansea,Uk
3335,3336,15/07/2019,DEB,Brontosaurus Vegan,18.07,,3387.68,Dine Out,Swansea,Uk
3336,3337,15/07/2019,DEB,MARKS&SPENCER PLC,7.7,,3405.75,Clothes,,
3337,3338,15/07/2019,DEB,Audible.co.uk,18.0,,3413.45,Entertainment,Swansea,Uk
3338,3339,15/07/2019,DEB,ZINCO LOUNGE,7.65,,3431.45,Dine Out,Swansea,Uk
3339,3340,15/07/2019,DEB,AMZNMktplace,3.04,,3439.1,Amazon,Swansea,Uk
3340,3341,15/07/2019,DEB,URBANZENINSTRUCTOR,7.0,,3442.14,Services,Swansea,Uk
3341,3342,15/07/2019,BP,SAVE THE CHANGE,0.97,,3449.14,Savings,Swansea,Uk
3342,3343,15/07/2019,CPT,LNK 1 UNION STREET,200.0,,3450.11,Cash,Leicester,Uk
3343,3344,12/07/2019,DEB,EASYJET   000EXG,298.48,,3650.11,Travel,,
3344,3345,12/07/2019,DEB,HOSTEL WORLD,61.55,,3948.59,Hotels,,
3345,3346,11/07/2019,BP,SAVE THE CHANGE,0.15,,4010.14,Savings,Swansea,Uk
3346,3347,10/07/2019,DEB,ZINCO LOUNGE,19.85,,4010.29,Dine Out,Swansea,Uk
3347,3348,10/07/2019,BP,SAVE THE CHANGE,0.08,,4030.14,Savings,Swansea,Uk
3348,3349,09/07/2019,DEB,AMZNMKTPLACE AMAZO,4.92,,4030.22,Amazon,Swansea,Uk
3349,3350,09/07/2019,CPT,LNK M&S SWANSEA,60.0,,4035.14,Cash,Swansea,Uk
3350,3351,09/07/2019,BP,SAVE THE CHANGE,1.72,,4095.14,Savings,Swansea,Uk
3351,3352,08/07/2019,DEB,TFW RAIL SERVICES,11.8,,4096.86,Travel,,
3352,3353,08/07/2019,DEB,AMZN Mktp UK*M635I,7.43,,4108.66,Amazon,Swansea,Uk
3353,3354,08/07/2019,DEB,SWANSEA UNI - CATE,8.05,,4116.09,Dine Out,Swansea,Uk
3354,3355,08/07/2019,DD,THE GYM LTD,14.99,,4124.14,Fitness,Swansea,Uk
3355,3356,08/07/2019,BP,SAVE THE CHANGE,0.6,,4139.13,Savings,Swansea,Uk
3356,3357,05/07/2019,DEB,AMZNMktplace,14.4,,4139.73,Amazon,Swansea,Uk
3357,3358,05/07/2019,CPT,LNK TESCO FABIAN W,100.0,,4154.13,Cash,Swansea,Uk
3358,3359,05/07/2019,BP,SAVE THE CHANGE,0.19,,4254.13,Savings,Swansea,Uk
3359,3360,04/07/2019,DEB,AMZNMKTPLACE AMAZO,1.81,,4254.32,Amazon,Swansea,Uk
3360,3361,03/07/2019,FPO,AMELIA TERESZKIEWI,40.0,,4256.13,Services,Swansea,Uk
3361,3362,03/07/2019,DEB,Amazon.co.uk*M60AR,9.0,,4296.13,Amazon,Swansea,Uk
3362,3363,03/07/2019,BGC,GOOGLE IRELAND,,82.04,4305.13,Supplementary Income,Swansea,Uk
3363,3364,02/07/2019,DEP,CLUB LLOYDS WAIVED,,3.0,4223.09,Supplementary Income,Swansea,Uk
3364,3365,02/07/2019,PAY,CLUB LLOYDS FEE,3.0,,4220.09,Bills,Swansea,Uk
3365,3366,02/07/2019,DD,ZURICH,20.69,,4223.09,Insurance,Swansea,Uk
3366,3367,02/07/2019,BP,SAVE THE CHANGE,2.77,,4243.78,Savings,Swansea,Uk
3367,3368,01/07/2019,,INTEREST (GROSS),,5.54,4246.55,Interest,Swansea,Uk
3368,3369,01/07/2019,DEB,ZINCO LOUNGE,13.05,,4241.01,Dine Out,Swansea,Uk
3369,3370,01/07/2019,DEB,ZARA SWANSEA,15.99,,4254.06,Clothes,Swansea,Uk
3370,3371,01/07/2019,DEB,COFFEE#1 SWANSEA,10.75,,4270.05,Dine Out,Swansea,Uk
3371,3372,01/07/2019,DEB,TESCO STORE 3241,8.19,,4280.8,Groceries,,
3372,3373,01/07/2019,DEB,MARKS&SPENCER PLC,1.0,,4288.99,Clothes,,
3373,3374,01/07/2019,DEB,TFW RAIL SERVICES,77.5,,4289.99,Travel,,
3374,3375,01/07/2019,DEB,BIRMINGHAM INT HOT,58.0,,4367.49,Hotels,Birmingham,Uk
3375,3376,01/07/2019,DEB,WASABI BIRMINGHAM,22.75,,4425.49,Dine Out,Birmingham,Uk
3376,3377,01/07/2019,DD,PRINCIPALITY BS,1163.58,,4448.24,Mortgage,Swansea,Uk
3377,3378,01/07/2019,DD,CC SWANSEA C.TAX,147.0,,5611.82,Bills,Swansea,Uk
3378,3379,01/07/2019,DD,GOOD ENERGY LTD,50.0,,5758.82,Bills,Swansea,Uk
3379,3380,01/07/2019,DD,DWR CYMRU W WATER,32.5,,5808.82,Bills,Swansea,Uk
3380,3381,01/07/2019,SO,ESAVINGS ACCOUNT,300.0,,5841.32,Savings,Swansea,Uk
3381,3382,01/07/2019,BP,SAVE THE CHANGE,0.6,,6141.32,Savings,Swansea,Uk
3382,3383,01/07/2019,CPT,LNK ESTATE AGENTS,50.0,,6141.92,Cash,Leeds,Uk
3383,3384,01/07/2019,CPT,LNK SWANSEA 1,100.0,,6191.92,Cash,Swansea,Uk
3384,3385,28/06/2019,DEB,WWW.III.CO.UK DE,1020.0,,6291.92,Investment,Nottingham,Uk
3385,3386,28/06/2019,DEB,ZINCO LOUNGE,14.4,,7311.92,Dine Out,Swansea,Uk
3386,3387,28/06/2019,DD,UCU B ACCOUNT,24.26,,7326.32,Others,Swansea,Uk
3387,3388,28/06/2019,BP,SAVE THE CHANGE,0.2,,7350.58,Savings,Swansea,Uk
3388,3389,28/06/2019,BGC,SWANSEA UNI - PAY,,3265.85,7350.78,Paycheck,Swansea,Uk
3389,3390,28/06/2019,BGC,GOOGLE IRELAND,,0.45,4084.93,Supplementary Income,Swansea,Uk
3390,3391,27/06/2019,DEB,WWW.III.CO.UK DE,2200.0,,4084.48,Investment,Nottingham,Uk
3391,3392,27/06/2019,DEB,TFW RAIL SERVICES,11.8,,6284.48,Travel,,
3392,3393,27/06/2019,BP,SAVE THE CHANGE,2.31,,6296.28,Savings,Swansea,Uk
3393,3394,26/06/2019,DEB,Brontosaurus Vegan,25.34,,6298.59,Dine Out,Swansea,Uk
3394,3395,26/06/2019,DEB,MARKS&SPENCER PLC,14.2,,6323.93,Clothes,,
3395,3396,26/06/2019,DEB,AMZNMKTPLACE AMAZO,6.15,,6338.13,Amazon,Swansea,Uk
3396,3397,26/06/2019,TFR,R LAWRENCE,,2000.0,6344.28,Supplementary Income,Swansea,Uk
3397,3398,25/06/2019,DEB,THE BIKE HUB,90.0,,4344.28,Other Shopping,,
3398,3399,25/06/2019,CPT,LNK TESCO FABIAN W,40.0,,4434.28,Cash,Swansea,Uk
3399,3400,25/06/2019,BP,SAVE THE CHANGE,1.09,,4474.28,Savings,Swansea,Uk
3400,3401,24/06/2019,DEB,Amazon.co.uk*M62FO,56.03,,4475.37,Amazon,Swansea,Uk
3401,3402,24/06/2019,DEB,AMZNMktplace,24.94,,4531.4,Amazon,Swansea,Uk
3402,3403,24/06/2019,DEB,AMZNMktplace,19.95,,4556.34,Amazon,Swansea,Uk
3403,3404,24/06/2019,DEB,Audible.co.uk,7.99,,4576.29,Entertainment,Swansea,Uk
3404,3405,24/06/2019,DD,CORGI HOMEPLAN,14.75,,4584.28,Home Improvement,Swansea,Uk
3405,3406,24/06/2019,BP,SAVE THE CHANGE,0.4,,4599.03,Savings,Swansea,Uk
3406,3407,24/06/2019,CPT,LNK 1 UNION STREET,60.0,,4599.43,Cash,Leicester,Uk
3407,3408,21/06/2019,DEB,SAINSBURY'S S/MKT,6.6,,4659.43,Groceries,,
3408,3409,21/06/2019,CPT,LNK TESCO FABIAN W,60.0,,4666.03,Cash,Swansea,Uk
3409,3410,21/06/2019,DD,VIRGIN MEDIA PYMTS,29.0,,4726.03,Bills,Swansea,Uk
3410,3411,20/06/2019,DEB,WWW.III.CO.UK DE,4000.0,,4755.03,Investment,Nottingham,Uk
3411,3412,20/06/2019,CPT,LNK DIAMOND PROPER,80.0,,8755.03,Cash,Leeds,Uk
3412,3413,20/06/2019,BP,SAVE THE CHANGE,0.33,,8835.03,Savings,Swansea,Uk
3413,3414,19/06/2019,DEB,CANDLES & CO,21.99,,8835.36,Other Shopping,,
3414,3415,19/06/2019,DEB,Audible.co.uk,18.0,,8857.35,Entertainment,Swansea,Uk
3415,3416,19/06/2019,DEB,POST OFFICE COUNTE,16.68,,8875.35,Others,Swansea,Uk
3416,3417,19/06/2019,TFR,R LAWRENCE,,4000.0,8892.03,Supplementary Income,Swansea,Uk
3417,3418,19/06/2019,BP,SAVE THE CHANGE,0.61,,4892.03,Savings,Swansea,Uk
3418,3419,18/06/2019,DEB,AMZNMKTPLACE AMAZO,18.52,,4892.64,Amazon,Swansea,Uk
3419,3420,18/06/2019,DEB,Amazon.co.uk*M64R1,6.87,,4911.16,Amazon,Swansea,Uk
3420,3421,18/06/2019,BP,SAVE THE CHANGE,0.33,,4918.03,Savings,Swansea,Uk
3421,3422,17/06/2019,DEB,Amazon.co.uk*M60D5,3.87,,4918.36,Amazon,Swansea,Uk
3422,3423,17/06/2019,DEB,LUL TICKET MACHINE,4.9,,4922.23,Travel,London,Uk
3423,3424,17/06/2019,DEB,TFW RAIL SERVICES,87.9,,4927.13,Travel,,
3424,3425,17/06/2019,DD,O2,22.58,,5015.03,Other Shopping,Swansea,Uk
3425,3426,17/06/2019,CPT,LOYD LOYD 802 OXFO,50.0,,5037.61,Cash,Swansea,Uk
3426,3427,14/06/2019,CPT,LNK TESCO FABIAN W,120.0,,5087.61,Cash,Swansea,Uk
3427,3428,13/06/2019,DEB,WWW.III.CO.UK DE,2600.0,,5207.61,Investment,Nottingham,Uk
3428,3429,12/06/2019,TFR,R LAWRENCE,,2800.0,7807.61,Supplementary Income,Swansea,Uk
3429,3430,12/06/2019,BP,SAVE THE CHANGE,0.6,,5007.61,Savings,Swansea,Uk
3430,3431,11/06/2019,DEB,WWW.III.CO.UK DE,2000.0,,5008.21,Investment,Swansea,Uk
3431,3432,11/06/2019,DEB,NON-GBP PURCH FEE,0.5,,7008.21,Others,Swansea,Uk
3432,3433,11/06/2019,DEB,NON-GBP TRANS FEE,0.25,,7008.71,Others,Swansea,Uk
3433,3434,11/06/2019,DEB,TRAINAWAY APS,8.4,,7008.96,Travel,,
3434,3435,10/06/2019,TFR,R LAWRENCE,,2000.0,7017.36,Supplementary Income,Swansea,Uk
3435,3436,10/06/2019,DEB,3830824-ONBB1,126.0,,5017.36,Others,Swansea,Uk
3436,3437,10/06/2019,CPT,LNK FABIAN WAY,50.0,,5143.36,Cash,Swansea,Uk
3437,3438,10/06/2019,BP,SAVE THE CHANGE,0.61,,5193.36,Savings,Swansea,Uk
3438,3439,10/06/2019,DEB,NON-GBP PURCH FEE,0.5,,5193.97,Others,Swansea,Uk
3439,3440,10/06/2019,DEB,NON-GBP TRANS FEE,0.25,,5194.47,Others,Swansea,Uk
3440,3441,10/06/2019,DEB,TRAINAWAY APS,8.39,,5194.72,Travel,,
3441,3442,07/06/2019,DEB,FOREIGN CASH FEE,1.5,,5203.11,Travel,,
3442,3443,07/06/2019,DEB,Shopping Domus Tri,197.37,,5204.61,Home Improvement,Swansea,Uk
3443,3444,07/06/2019,DD,THE GYM LTD,14.99,,5401.98,Fitness,Swansea,Uk
3444,3445,07/06/2019,BP,SAVE THE CHANGE,1.24,,5416.97,Savings,Swansea,Uk
3445,3446,06/06/2019,DEB,NON-GBP PURCH FEE,0.5,,5418.21,Others,Swansea,Uk
3446,3447,06/06/2019,DEB,NON-GBP TRANS FEE,0.25,,5418.71,Others,Swansea,Uk
3447,3448,06/06/2019,DEB,TRAINAWAY APS,8.37,,5418.96,Travel,,
3448,3449,06/06/2019,DEB,NON-GBP PURCH FEE,0.5,,5427.33,Others,Swansea,Uk
3449,3450,06/06/2019,DEB,NON-GBP TRANS FEE,0.25,,5427.83,Others,Swansea,Uk
3450,3451,06/06/2019,DEB,TRAINAWAY APS,8.39,,5428.08,Travel,,
3451,3452,06/06/2019,BP,SAVE THE CHANGE,0.62,,5436.47,Savings,Swansea,Uk
3452,3453,05/06/2019,DEB,NON-GBP PURCH FEE,0.5,,5437.09,Others,Swansea,Uk
3453,3454,05/06/2019,DEB,NON-GBP TRANS FEE,0.25,,5437.59,Others,Swansea,Uk
3454,3455,05/06/2019,DEB,TRAINAWAY APS,8.38,,5437.84,Travel,,
3455,3456,05/06/2019,BP,SAVE THE CHANGE,0.2,,5446.22,Savings,Swansea,Uk
3456,3457,04/06/2019,DEP,CLUB LLOYDS WAIVED,,3.0,5446.42,Supplementary Income,Swansea,Uk
3457,3458,04/06/2019,PAY,CLUB LLOYDS FEE,3.0,,5443.42,Bills,Swansea,Uk
3458,3459,04/06/2019,DEB,MEIA DUZIA,12.8,,5446.42,Other Shopping,,
3459,3460,04/06/2019,BP,SAVE THE CHANGE,2.34,,5459.22,Savings,Swansea,Uk
3460,3461,03/06/2019,,INTEREST (GROSS),,6.48,5461.56,Interest,Swansea,Uk
3461,3462,03/06/2019,DEB,NON-GBP PURCH FEE,0.5,,5455.08,Others,Swansea,Uk
3462,3463,03/06/2019,DEB,NON-GBP TRANS FEE,0.26,,5455.58,Others,Swansea,Uk
3463,3464,03/06/2019,DEB,RESTAURANTE DA TER,8.79,,5455.84,Dine Out,London,Uk
3464,3465,03/06/2019,DEB,NON-GBP PURCH FEE,0.5,,5464.63,Others,Swansea,Uk
3465,3466,03/06/2019,DEB,NON-GBP TRANS FEE,0.25,,5465.13,Others,Swansea,Uk
3466,3467,03/06/2019,DEB,TRAINAWAY APS,8.37,,5465.38,Travel,,
3467,3468,03/06/2019,DEB,TFW RAIL SERVICES,50.4,,5473.75,Travel,,
3468,3469,03/06/2019,DEB,MINIPRECO LOIOS 2,20.65,,5524.15,Groceries,Porto,Portugal
3469,3470,03/06/2019,DEB,M&S SIMPLY FOOD-SS,7.65,,5544.8,Groceries,Swansea,Uk
3470,3471,03/06/2019,DEB,WWW.III.CO.UK DE,1000.0,,5552.45,Investment,Swansea,Uk
3471,3472,03/06/2019,DEB,SAINSBURY'S S/MKT,19.8,,6552.45,Groceries,,
3472,3473,03/06/2019,DD,PRINCIPALITY BS,957.26,,6572.25,Mortgage,Swansea,Uk
3473,3474,03/06/2019,DD,CC SWANSEA C.TAX,147.0,,7529.51,Bills,Swansea,Uk
3474,3475,03/06/2019,DD,GOOD ENERGY LTD,50.0,,7676.51,Bills,Swansea,Uk
3475,3476,03/06/2019,DD,DWR CYMRU W WATER,32.5,,7726.51,Bills,Swansea,Uk
3476,3477,03/06/2019,DD,ZURICH,20.69,,7759.01,Insurance,Swansea,Uk
3477,3478,03/06/2019,SO,ESAVINGS ACCOUNT,300.0,,7779.7,Savings,Swansea,Uk
3478,3479,31/05/2019,TFR,R LAWRENCE,,1000.0,8079.7,Supplementary Income,Swansea,Uk
3479,3480,31/05/2019,DEB,WWW.III.CO.UK DE,200.0,,7079.7,Investment,Nottingham,Uk
3480,3481,31/05/2019,DD,UCU B ACCOUNT,24.26,,7279.7,Others,Swansea,Uk
3481,3482,31/05/2019,BGC,SWANSEA UNI - PAY,,3265.85,7303.96,Paycheck,Swansea,Uk
3482,3483,30/05/2019,CPT,LNK TESCO FABIAN W,60.0,,4038.11,Cash,Swansea,Uk
3483,3484,30/05/2019,BP,SAVE THE CHANGE,0.23,,4098.11,Savings,Swansea,Uk
3484,3485,29/05/2019,DEB,AMZNMktplace,1.77,,4098.34,Amazon,Swansea,Uk
3485,3486,29/05/2019,CPT,LNK TESCO FABIAN W,40.0,,4100.11,Cash,Swansea,Uk
3486,3487,29/05/2019,BP,SAVE THE CHANGE,2.27,,4140.11,Savings,Swansea,Uk
3487,3488,28/05/2019,DEB,AMZNMktplace,12.49,,4142.38,Amazon,Swansea,Uk
3488,3489,28/05/2019,DEB,SWANSEA FOOD CENTR,7.46,,4154.87,Dine Out,Swansea,Uk
3489,3490,28/05/2019,DEB,AMZNMKTPLACE AMAZO,3.33,,4162.33,Amazon,Swansea,Uk
3490,3491,28/05/2019,DEB,AMZN MKTP UK*MN36N,5.99,,4165.66,Amazon,Swansea,Uk
3491,3492,28/05/2019,DEB,WWW.III.CO.UK DE,5000.0,,4171.65,Investment,Nottingham,Uk
3492,3493,28/05/2019,DEB,POST OFFICE COUNTE,27.62,,9171.65,Others,Swansea,Uk
3493,3494,28/05/2019,DEB,Brontosaurus Vegan,16.95,,9199.27,Dine Out,Swansea,Uk
3494,3495,28/05/2019,DEB,MARKS&SPENCER PLC,8.9,,9216.22,Clothes,,
3495,3496,28/05/2019,DEB,AMAZON.CO.UK*MN9V3,12.99,,9225.12,Amazon,Swansea,Uk
3496,3497,28/05/2019,BP,SAVE THE CHANGE,0.01,,9238.11,Savings,Swansea,Uk
3497,3498,28/05/2019,CPT,LNK M&S SWANSEA,50.0,,9238.12,Cash,Swansea,Uk
3498,3499,28/05/2019,TFR,R LAWRENCE  25MAY19,,5000.0,9288.12,Supplementary Income,Swansea,Uk
3499,3500,24/05/2019,CPT,LNK TESCO FABIAN W,50.0,,4288.12,Cash,Swansea,Uk
3500,3501,24/05/2019,DEB,TESCO STORES 4628,5.0,,4338.12,Groceries,,
3501,3502,24/05/2019,DEB,Audible.co.uk,7.99,,4343.12,Entertainment,Swansea,Uk
3502,3503,24/05/2019,BP,SAVE THE CHANGE,1.48,,4351.11,Savings,Swansea,Uk
3503,3504,23/05/2019,DEB,NON-GBP PURCH FEE,0.5,,4352.59,Others,Swansea,Uk
3504,3505,23/05/2019,DEB,NON-GBP TRANS FEE,15.82,,4353.09,Others,Swansea,Uk
3505,3506,23/05/2019,DEB,2160701-KEGHB,529.11,,4368.91,Others,Swansea,Uk
3506,3507,23/05/2019,DEB,AMZN MKTP UK*MN1H1,18.41,,4898.02,Amazon,Swansea,Uk
3507,3508,22/05/2019,CPT,LNK TESCO FABIAN W,50.0,,4916.43,Cash,Swansea,Uk
3508,3509,22/05/2019,DD,CORGI HOMEPLAN,14.75,,4966.43,Home Improvement,Swansea,Uk
3509,3510,21/05/2019,DD,VIRGIN MEDIA PYMTS,29.0,,4981.18,Bills,Swansea,Uk
3510,3511,21/05/2019,BP,SAVE THE CHANGE,2.5,,5010.18,Savings,Swansea,Uk
3511,3512,20/05/2019,DEB,Amazon.co.uk*MN9ZF,16.33,,5012.68,Amazon,Swansea,Uk
3512,3513,20/05/2019,DEB,AMAZON.CO.UK*MN6LS,9.79,,5029.01,Amazon,Swansea,Uk
3513,3514,20/05/2019,DEB,Brontosaurus Vegan,29.18,,5038.8,Dine Out,Swansea,Uk
3514,3515,20/05/2019,DEB,MARKS&SPENCER PLC,4.7,,5067.98,Clothes,,
3515,3516,20/05/2019,DEB,SWANSEA UNI - CATE,13.5,,5072.68,Dine Out,Swansea,Uk
3516,3517,20/05/2019,CPT,LNK TESCO FABIAN W,60.0,,5086.18,Cash,Swansea,Uk
3517,3518,20/05/2019,CPT,LNK SWANSEA CITY C,50.0,,5146.18,Cash,Swansea,Uk
3518,3519,17/05/2019,CPT,LNK TESCO FABIAN W,60.0,,5196.18,Cash,Swansea,Uk
3519,3520,16/05/2019,DD,O2,27.14,,5256.18,Other Shopping,Swansea,Uk
3520,3521,16/05/2019,BP,SAVE THE CHANGE,0.49,,5283.32,Savings,Swansea,Uk
3521,3522,15/05/2019,DEB,NON-GBP PURCH FEE,0.5,,5283.81,Others,Swansea,Uk
3522,3523,15/05/2019,DEB,NON-GBP TRANS FEE,0.31,,5284.31,Others,Swansea,Uk
3523,3524,15/05/2019,DEB,HMSHOST AMSTERDAM,10.51,,5284.62,Dine Out,Amsterdam,Netherlands
3524,3525,15/05/2019,BP,SAVE THE CHANGE,1.27,,5295.13,Savings,Swansea,Uk
3525,3526,14/05/2019,DEB,SAINSBURY'S S/MKT,9.9,,5296.4,Groceries,,
3526,3527,14/05/2019,DEB,AMZNMKTPLACE AMAZO,2.32,,5306.3,Amazon,Swansea,Uk
3527,3528,14/05/2019,DEB,DOUBLETREE BY HILT,105.0,,5308.62,Hotels,,
3528,3529,14/05/2019,CPT,LNK FABIAN WAY,50.0,,5413.62,Cash,Swansea,Uk
3529,3530,14/05/2019,DEB,NON-GBP PURCH FEE,0.5,,5463.62,Others,Swansea,Uk
3530,3531,14/05/2019,DEB,NON-GBP TRANS FEE,0.28,,5464.12,Others,Swansea,Uk
3531,3532,14/05/2019,DEB,BAR BIGO,9.51,,5464.4,Dine Out,Paris,France
3532,3533,14/05/2019,BP,SAVE THE CHANGE,0.37,,5473.91,Savings,Swansea,Uk
3533,3534,13/05/2019,DEB,NH GENOVA CENTRO,740.63,,5474.28,Hotels,Genova,Italy
3534,3535,13/05/2019,DEB,NON-GBP CASH FEE,1.5,,6214.91,Others,Swansea,Uk
3535,3536,13/05/2019,DEB,NON-GBP TRANS FEE,2.58,,6216.41,Others,Swansea,Uk
3536,3537,13/05/2019,DEB,ABN-AMRO,86.45,,6218.99,Travel,,
3537,3538,13/05/2019,BP,SAVE THE CHANGE,0.39,,6305.44,Savings,Swansea,Uk
3538,3539,10/05/2019,DEB,NON-GBP PURCH FEE,0.5,,6305.83,Others,Swansea,Uk
3539,3540,10/05/2019,DEB,NON-GBP TRANS FEE,0.61,,6306.33,Others,Swansea,Uk
3540,3541,10/05/2019,DEB,JAPAN RESTAURANT,20.61,,6306.94,Dine Out,,
3541,3542,10/05/2019,BP,SAVE THE CHANGE,0.69,,6327.55,Savings,Swansea,Uk
3542,3543,09/05/2019,DEB,NON-GBP PURCH FEE,0.5,,6328.24,Others,Swansea,Uk
3543,3544,09/05/2019,DEB,NON-GBP TRANS FEE,0.76,,6328.74,Others,Swansea,Uk
3544,3545,09/05/2019,DEB,CELIO 6309,25.74,,6329.5,Clothes,,
3545,3546,09/05/2019,DEB,NON-GBP PURCH FEE,0.5,,6355.24,Others,Swansea,Uk
3546,3547,09/05/2019,DEB,NON-GBP TRANS FEE,0.25,,6355.74,Others,Swansea,Uk
3547,3548,09/05/2019,DEB,H & M  5,8.57,,6355.99,Clothes,,
3548,3549,08/05/2019,BP,SAVE THE CHANGE,2.51,,6364.56,Savings,Swansea,Uk
3549,3550,07/05/2019,DEB,Amazon.co.uk*MN59F,6.29,,6367.07,Amazon,Swansea,Uk
3550,3551,07/05/2019,DEB,NON-GBP PURCH FEE,0.5,,6373.36,Others,Swansea,Uk
3551,3552,07/05/2019,DEB,NON-GBP TRANS FEE,0.84,,6373.86,Others,Swansea,Uk
3552,3553,07/05/2019,DEB,H & M  5,28.32,,6374.7,Clothes,,
3553,3554,07/05/2019,DEB,NON-GBP CASH FEE,1.5,,6403.02,Others,Swansea,Uk
3554,3555,07/05/2019,DEB,NON-GBP TRANS FEE,5.13,,6404.52,Others,Swansea,Uk
3555,3556,07/05/2019,DEB,BANCA CARIGE CR GE,171.76,,6409.65,Travel,,
3556,3557,07/05/2019,DEB,TFW RAIL SERVICES,50.4,,6581.41,Travel,,
3557,3558,07/05/2019,DEB,AMZNMKTPLACE AMAZO,5.48,,6631.81,Amazon,Swansea,Uk
3558,3559,07/05/2019,DD,THE GYM LTD,14.99,,6637.29,Fitness,Swansea,Uk
3559,3560,03/05/2019,DD,ASSURANT INTER LTD,21.15,,6652.28,Insurance,Swansea,Uk
3560,3561,03/05/2019,BP,SAVE THE CHANGE,0.25,,6673.43,Savings,Swansea,Uk
3561,3562,02/05/2019,DEP,CLUB LLOYDS WAIVED,,3.0,6673.68,Supplementary Income,Swansea,Uk
3562,3563,02/05/2019,PAY,CLUB LLOYDS FEE,3.0,,6670.68,Bills,Swansea,Uk
3563,3564,02/05/2019,DEB,Lush UK,16.95,,6673.68,Other Shopping,,
3564,3565,02/05/2019,DEB,SAINSBURYS S/MKTS,16.8,,6690.63,Groceries,,
3565,3566,02/05/2019,CPT,LNK TESCO FABIAN W,60.0,,6707.43,Cash,Swansea,Uk
3566,3567,02/05/2019,BP,SAVE THE CHANGE,0.05,,6767.43,Savings,Swansea,Uk
3567,3568,01/05/2019,,INTEREST (GROSS),,6.12,6767.48,Interest,Swansea,Uk
3568,3569,01/05/2019,DEB,SAINSBURYS S/MKTS,15.0,,6761.36,Groceries,,
3569,3570,01/05/2019,DEB,TESCO STORES 4628,3.95,,6776.36,Groceries,,
3570,3571,01/05/2019,CPT,LNK SAINSBURYS BAN,50.0,,6780.31,Cash,,
3571,3572,01/05/2019,DD,PRINCIPALITY BS,957.26,,6830.31,Mortgage,Swansea,Uk
3572,3573,01/05/2019,DD,CC SWANSEA C.TAX,147.0,,7787.57,Bills,Swansea,Uk
3573,3574,01/05/2019,DD,GOOD ENERGY LTD,97.0,,7934.57,Bills,Swansea,Uk
3574,3575,01/05/2019,DD,DWR CYMRU W WATER,32.5,,8031.57,Bills,Swansea,Uk
3575,3576,01/05/2019,DD,ZURICH,20.69,,8064.07,Insurance,Swansea,Uk
3576,3577,01/05/2019,SO,ESAVINGS ACCOUNT,300.0,,8084.76,Savings,Swansea,Uk
3577,3578,30/04/2019,DD,UCU B ACCOUNT,24.26,,8384.76,Others,Swansea,Uk
3578,3579,30/04/2019,BP,SAVE THE CHANGE,1.18,,8409.02,Savings,Swansea,Uk
3579,3580,30/04/2019,BGC,SWANSEA UNI - PAY,,3265.85,8410.2,Paycheck,Swansea,Uk
3580,3581,29/04/2019,DEB,WWW.III.CO.UK DE,3000.0,,5144.35,Investment,Nottingham,Uk
3581,3582,29/04/2019,DEB,HATHWAY HOUSE ACCO,55.0,,8144.35,Hotels,Bristol,Uk
3582,3583,29/04/2019,DEB,PAYPAL *DISC HEALT,39.95,,8199.35,Services,Swansea,Uk
3583,3584,29/04/2019,DEB,Brontosaurus Vegan,18.57,,8239.3,Dine Out,Swansea,Uk
3584,3585,29/04/2019,DEB,POST OFFICE COUNTE,17.8,,8257.87,Others,Swansea,Uk
3585,3586,29/04/2019,DEB,THE BODY SHOP INTL,15.0,,8275.67,Other Shopping,,
3586,3587,29/04/2019,DEB,MARKS&SPENCER PLC,8.5,,8290.67,Clothes,,
3587,3588,29/04/2019,BP,SAVE THE CHANGE,0.66,,8299.17,Savings,Swansea,Uk
3588,3589,29/04/2019,TFR,R LAWRENCE  28APR19,,1000.0,8299.83,Supplementary Income,Swansea,Uk
3589,3590,26/04/2019,DEB,AMZNMktplace,2.34,,7299.83,Amazon,Swansea,Uk
3590,3591,26/04/2019,CPT,LNK TESCO FABIAN W,60.0,,7302.17,Cash,Swansea,Uk
3591,3592,25/04/2019,CPT,LNK TESCO FABIAN W,100.0,,7362.17,Cash,Swansea,Uk
3592,3593,25/04/2019,BP,SAVE THE CHANGE,0.01,,7462.17,Savings,Swansea,Uk
3593,3594,24/04/2019,DEB,Audible.co.uk,7.99,,7462.18,Entertainment,Swansea,Uk
3594,3595,24/04/2019,BP,SAVE THE CHANGE,1.06,,7470.17,Savings,Swansea,Uk
3595,3596,23/04/2019,DEB,WM MORRISONS STORE,44.91,,7471.23,Groceries,,
3596,3597,23/04/2019,DEB,Brontosaurus Vegan,23.62,,7516.14,Dine Out,Swansea,Uk
3597,3598,23/04/2019,DEB,AMAZON.CO.UK*MZ3T6,11.81,,7539.76,Amazon,Swansea,Uk
3598,3599,23/04/2019,DEB,MARKS&SPENCER PLC,8.8,,7551.57,Clothes,,
3599,3600,23/04/2019,DEB,COFFEE#1 SWANSEA,3.8,,7560.37,Dine Out,Swansea,Uk
3600,3601,23/04/2019,CPT,LNK TESCO FABIAN W,60.0,,7564.17,Cash,Swansea,Uk
3601,3602,23/04/2019,DD,VIRGIN MEDIA PYMTS,29.0,,7624.17,Bills,Swansea,Uk
3602,3603,23/04/2019,DD,CORGI HOMEPLAN,14.75,,7653.17,Home Improvement,Swansea,Uk
3603,3604,18/04/2019,CPT,LNK TESCO FABIAN W,50.0,,7667.92,Cash,Swansea,Uk
3604,3605,18/04/2019,BP,SAVE THE CHANGE,0.47,,7717.92,Savings,Swansea,Uk
3605,3606,17/04/2019,DEB,AMZNMktplace,7.93,,7718.39,Amazon,Swansea,Uk
3606,3607,17/04/2019,DEB,AMZNMKTPLACE AMAZO,3.6,,7726.32,Amazon,Swansea,Uk
3607,3608,16/04/2019,CPT,LNK FABIAN WAY,150.0,,7729.92,Cash,Swansea,Uk
3608,3609,16/04/2019,DD,O2,18.94,,7879.92,Other Shopping,Swansea,Uk
3609,3610,16/04/2019,BP,SAVE THE CHANGE,1.62,,7898.86,Savings,Swansea,Uk
3610,3611,15/04/2019,DEB,SAINSBURY'S S/MKT,20.06,,7900.48,Groceries,,
3611,3612,15/04/2019,DEB,Brontosaurus Vegan,14.72,,7920.54,Dine Out,Swansea,Uk
3612,3613,15/04/2019,DEB,MARKS&SPENCER PLC,6.7,,7935.26,Clothes,,
3613,3614,15/04/2019,DEB,KLM UK  074341,304.9,,7941.96,Travel,,
3614,3615,15/04/2019,CPT,LNK TESCO FABIAN W,250.0,,8246.86,Cash,Swansea,Uk
3615,3616,15/04/2019,CPT,LOYD LOYD 802 OXFO,40.0,,8496.86,Cash,Swansea,Uk
3616,3617,12/04/2019,BP,SAVE THE CHANGE,0.12,,8536.86,Savings,Swansea,Uk
3617,3618,11/04/2019,DEB,AMZNMktplace,14.88,,8536.98,Amazon,Swansea,Uk
3618,3619,11/04/2019,BP,SAVE THE CHANGE,0.36,,8551.86,Savings,Swansea,Uk
3619,3620,10/04/2019,DEB,EASYJET   000EWX,85.64,,8552.22,Travel,,
3620,3621,10/04/2019,DEB,EXPEDIA 7425718119,3.0,,8637.86,Travel,,
3621,3622,10/04/2019,CPT,LNK TESCO FABIAN W,40.0,,8640.86,Cash,Swansea,Uk
3622,3623,09/04/2019,CPT,LNK TESCO FABIAN W,40.0,,8680.86,Cash,Swansea,Uk
3623,3624,09/04/2019,BP,SAVE THE CHANGE,2.13,,8720.86,Savings,Swansea,Uk
3624,3625,08/04/2019,DEB,THE GYM LTD,29.99,,8722.99,Fitness,Swansea,Uk
3625,3626,08/04/2019,DEB,AMZNMktplace,15.66,,8752.98,Amazon,Swansea,Uk
3626,3627,08/04/2019,DEB,Brontosaurus Vegan,19.02,,8768.64,Dine Out,Swansea,Uk
3627,3628,08/04/2019,DEB,MARKS&SPENCER PLC,7.2,,8787.66,Clothes,,
3628,3629,08/04/2019,DD,LV LIFE,37.12,,8794.86,Insurance,Swansea,Uk
3629,3630,08/04/2019,BP,SAVE THE CHANGE,0.01,,8831.98,Savings,Swansea,Uk
3630,3631,05/04/2019,CPT,LNK M&S SWANSEA,50.0,,8831.99,Cash,Swansea,Uk
3631,3632,05/04/2019,DEB,THE GYM LTD,7.99,,8881.99,Fitness,Swansea,Uk
3632,3633,05/04/2019,BP,SAVE THE CHANGE,0.19,,8889.98,Savings,Swansea,Uk
3633,3634,04/04/2019,DEB,WWW.III.CO.UK DE,5000.0,,8890.17,Investment,Swansea,Uk
3634,3635,04/04/2019,DEB,AMZNMktplace,5.81,,13890.17,Amazon,Swansea,Uk
3635,3636,04/04/2019,BP,SAVE THE CHANGE,1.23,,13895.98,Savings,Swansea,Uk
3636,3637,03/04/2019,DEB,AMZNMktplace,24.28,,13897.21,Amazon,Swansea,Uk
3637,3638,03/04/2019,DEB,Amazon.co.uk*MZ275,10.49,,13921.49,Amazon,Swansea,Uk
3638,3639,03/04/2019,CPT,LNK TESCO FABIAN W,40.0,,13931.98,Cash,Swansea,Uk
3639,3640,03/04/2019,DD,ASSURANT INTER LTD,21.15,,13971.98,Insurance,Swansea,Uk
3640,3641,02/04/2019,DEP,CLUB LLOYDS WAIVED,,3.0,13993.13,Supplementary Income,Swansea,Uk
3641,3642,02/04/2019,PAY,CLUB LLOYDS FEE,3.0,,13990.13,Bills,Swansea,Uk
3642,3643,02/04/2019,DD,ZURICH,20.69,,13993.13,Insurance,Swansea,Uk
3643,3644,02/04/2019,BP,SAVE THE CHANGE,2.47,,14013.82,Savings,Swansea,Uk
3644,3645,01/04/2019,,INTEREST (GROSS),,6.33,14016.29,Interest,Swansea,Uk
3645,3646,01/04/2019,DEB,Brontosaurus Vegan,16.62,,14009.96,Dine Out,Swansea,Uk
3646,3647,01/04/2019,DEB,POST OFFICE COUNTE,12.76,,14026.58,Others,Swansea,Uk
3647,3648,01/04/2019,DEB,MARKS&SPENCER PLC,7.1,,14039.34,Clothes,,
3648,3649,01/04/2019,DEB,PAYPAL *JAKUBSTADT,81.05,,14046.44,Services,Swansea,Uk
3649,3650,01/04/2019,DD,PRINCIPALITY BS,957.26,,14127.49,Mortgage,Swansea,Uk
3650,3651,01/04/2019,DD,CC SWANSEA C.TAX,145.69,,15084.75,Bills,Swansea,Uk
3651,3652,01/04/2019,DD,GOOD ENERGY LTD,97.0,,15230.44,Bills,Swansea,Uk
3652,3653,01/04/2019,DD,DWR CYMRU W WATER,32.5,,15327.44,Bills,Swansea,Uk
3653,3654,01/04/2019,SO,ESAVINGS ACCOUNT,300.0,,15359.94,Savings,Swansea,Uk
3654,3655,01/04/2019,CPT,LNK 1 UNION STREET,40.0,,15659.94,Cash,Leicester,Uk
3655,3656,29/03/2019,CPT,LNK TESCO FABIAN W,40.0,,15699.94,Cash,Swansea,Uk
3656,3657,29/03/2019,DD,UCU B ACCOUNT,24.26,,15739.94,Others,Swansea,Uk
3657,3658,29/03/2019,BP,SAVE THE CHANGE,0.5,,15764.2,Savings,Swansea,Uk
3658,3659,29/03/2019,BGC,SWANSEA UNI - PAY,,3251.36,15764.7,Paycheck,Swansea,Uk
3659,3660,28/03/2019,DEB,AMZN MKTP UK*MZ4YK,2.5,,12513.34,Amazon,Swansea,Uk
3660,3661,27/03/2019,BP,SAVE THE CHANGE,0.7,,12515.84,Savings,Swansea,Uk
3661,3662,26/03/2019,DEB,SAINSBURY'S S/MKT,29.3,,12516.54,Groceries,,
3662,3663,26/03/2019,BP,SAVE THE CHANGE,1.41,,12545.84,Savings,Swansea,Uk
3663,3664,25/03/2019,DEB,ZINCO LOUNGE,14.75,,12547.25,Dine Out,Swansea,Uk
3664,3665,25/03/2019,DEB,Brontosaurus Vegan,15.05,,12562.0,Dine Out,Swansea,Uk
3665,3666,25/03/2019,DEB,MARKS&SPENCER PLC,10.8,,12577.05,Clothes,,
3666,3667,25/03/2019,DEB,Audible.co.uk,7.99,,12587.85,Entertainment,Swansea,Uk
3667,3668,25/03/2019,CPT,LNK TESCO FABIAN W,50.0,,12595.84,Cash,Swansea,Uk
3668,3669,25/03/2019,BP,SAVE THE CHANGE,0.69,,12645.84,Savings,Swansea,Uk
3669,3670,22/03/2019,CPT,LNK TESCO FABIAN W,30.0,,12646.53,Cash,Swansea,Uk
3670,3671,22/03/2019,DD,CORGI HOMEPLAN,14.75,,12676.53,Home Improvement,Swansea,Uk
3671,3672,22/03/2019,DEB,NON-GBP PURCH FEE,0.5,,12691.28,Others,Swansea,Uk
3672,3673,22/03/2019,DEB,NON-GBP TRANS FEE,6.64,,12691.78,Others,Swansea,Uk
3673,3674,22/03/2019,DEB,B.COM 2160701-KEGH,222.31,,12698.42,,,
3674,3675,22/03/2019,BP,SAVE THE CHANGE,0.56,,12920.73,Savings,Swansea,Uk
3675,3676,21/03/2019,DEB,AMZN Mktp UK*MW55R,17.7,,12921.29,Amazon,Swansea,Uk
3676,3677,21/03/2019,DEB,KLM UK  074341,443.74,,12938.99,Travel,,
3677,3678,21/03/2019,DD,VIRGIN MEDIA PYMTS,29.0,,13382.73,Bills,Swansea,Uk
3678,3679,21/03/2019,BP,SAVE THE CHANGE,0.97,,13411.73,Savings,Swansea,Uk
3679,3680,20/03/2019,DEB,AMZN Mktp UK*MW0N1,9.03,,13412.7,Amazon,Swansea,Uk
3680,3681,20/03/2019,DEB,EXPEDIA 7420654555,3.0,,13421.73,Travel,,
3681,3682,20/03/2019,BP,SAVE THE CHANGE,0.86,,13424.73,Savings,Swansea,Uk
3682,3683,19/03/2019,DEB,AMZN Mktp UK*MW1XF,6.14,,13425.59,Amazon,Swansea,Uk
3683,3684,19/03/2019,CPT,LNK FABIAN WAY,50.0,,13431.73,Cash,Swansea,Uk
3684,3685,19/03/2019,BP,SAVE THE CHANGE,0.3,,13481.73,Savings,Swansea,Uk
3685,3686,18/03/2019,DEB,THE BIKE HUB,20.0,,13482.03,Other Shopping,,
3686,3687,18/03/2019,DEB,MARKS&SPENCER PLC,4.7,,13502.03,Clothes,,
3687,3688,18/03/2019,DD,O2,17.95,,13506.73,Other Shopping,Swansea,Uk
3688,3689,18/03/2019,CPT,LNK M&S SWANSEA,40.0,,13524.68,Cash,Swansea,Uk
3689,3690,15/03/2019,CPT,LNK TESCO FABIAN W,40.0,,13564.68,Cash,Swansea,Uk
3690,3691,15/03/2019,BGC,SWANSEA UNIVERSITY,,264.95,13604.68,Supplementary Income,Swansea,Uk
3691,3692,14/03/2019,BP,SAVE THE CHANGE,0.5,,13339.73,Savings,Swansea,Uk
3692,3693,13/03/2019,DEB,AMZN MKTP UK*MW1F6,15.9,,13340.23,Amazon,Swansea,Uk
3693,3694,13/03/2019,DEB,TESCO STORES 4628,6.6,,13356.13,Groceries,,
3694,3695,12/03/2019,CPT,LNK TESCO FABIAN W,40.0,,13362.73,Cash,Swansea,Uk
3695,3696,12/03/2019,BP,SAVE THE CHANGE,0.67,,13402.73,Savings,Swansea,Uk
3696,3697,11/03/2019,DEB,Brontosaurus Vegan,33.72,,13403.4,Dine Out,Swansea,Uk
3697,3698,11/03/2019,DEB,MARKS&SPENCER PLC,5.0,,13437.12,Clothes,,
3698,3699,11/03/2019,DEB,Amazon Prime*MW23K,79.0,,13442.12,Amazon,Swansea,Uk
3699,3700,11/03/2019,DEB,AMZN Mktp UK*MW6U6,7.61,,13521.12,Amazon,Swansea,Uk
3700,3701,08/03/2019,CPT,LNK FABIAN WAY,50.0,,13528.73,Cash,Swansea,Uk
3701,3702,08/03/2019,DD,LV LIFE,37.12,,13578.73,Insurance,Swansea,Uk
3702,3703,08/03/2019,BP,SAVE THE CHANGE,0.99,,13615.85,Savings,Swansea,Uk
3703,3704,07/03/2019,DEB,AMAZON.CO.UK*MW8G9,13.01,,13616.84,Amazon,Swansea,Uk
3704,3705,07/03/2019,CPT,LNK TESCO FABIAN W,40.0,,13629.85,Cash,Swansea,Uk
3705,3706,07/03/2019,BP,SAVE THE CHANGE,0.51,,13669.85,Savings,Swansea,Uk
3706,3707,06/03/2019,DEB,AMZN MKTP UK*MW4GI,23.49,,13670.36,Amazon,Swansea,Uk
3707,3708,06/03/2019,CPT,LNK FABIAN WAY,50.0,,13693.85,Cash,Swansea,Uk
3708,3709,06/03/2019,BP,SAVE THE CHANGE,0.27,,13743.85,Savings,Swansea,Uk
3709,3710,05/03/2019,DEB,AMZN Mktp UK*MW6J9,35.73,,13744.12,Amazon,Swansea,Uk
3710,3711,05/03/2019,BP,SAVE THE CHANGE,2.2,,13779.85,Savings,Swansea,Uk
3711,3712,04/03/2019,DEP,CLUB LLOYDS WAIVED,,3.0,13782.05,Amazon,Swansea,Uk
3712,3713,04/03/2019,PAY,CLUB LLOYDS FEE,3.0,,13779.05,Bills,Swansea,Uk
3713,3714,04/03/2019,DEB,Amazon.co.uk*MW4OW,16.15,,13782.05,Supplementary Income,Swansea,Uk
3714,3715,04/03/2019,DEB,MARKS&SPENCER PLC,9.2,,13798.2,Clothes,,
3715,3716,04/03/2019,DEB,COFFEE#1 SWANSEA,8.8,,13807.4,Dine Out,Swansea,Uk
3716,3717,04/03/2019,DEB,AMZN Mktp UK*MW8PN,11.65,,13816.2,Amazon,Swansea,Uk
3717,3718,01/03/2019,,INTEREST (GROSS),,5.71,13827.85,Interest,Swansea,Uk
3718,3719,01/03/2019,CPT,LNK TESCO FABIAN W,50.0,,13822.14,Cash,Swansea,Uk
3719,3720,01/03/2019,DD,PRINCIPALITY BS,957.26,,13872.14,Mortgage,Swansea,Uk
3720,3721,01/03/2019,DD,GOOD ENERGY LTD,97.0,,14829.4,Bills,Swansea,Uk
3721,3722,01/03/2019,DD,AVIVA LIFE,46.46,,14926.4,Insurance,Swansea,Uk
3722,3723,01/03/2019,DD,DWR CYMRU W WATER,23.5,,14972.86,Bills,Swansea,Uk
3723,3724,01/03/2019,DD,ASSURANT INTER LTD,21.15,,14996.36,Insurance,Swansea,Uk
3724,3725,01/03/2019,DD,ZURICH,20.69,,15017.51,Insurance,Swansea,Uk
3725,3726,01/03/2019,DD,CC SWANSEA C.TAX,13.0,,15038.2,Bills,Swansea,Uk
3726,3727,01/03/2019,SO,ESAVINGS ACCOUNT,300.0,,15051.2,Savings,Swansea,Uk
3727,3728,01/03/2019,BGC,SWANSEA UNIVERSITY,,123.2,15351.2,Supplementary Income,Swansea,Uk
3728,3729,28/02/2019,DD,UCU B ACCOUNT,24.26,,15228.0,Others,Swansea,Uk
3729,3730,28/02/2019,BGC,SWANSEA UNI - PAY,,3250.96,15252.26,Paycheck,Swansea,Uk
3730,3731,28/02/2019,BGC,MIDDLESEX UNIV,,404.95,12001.3,Supplementary Income,Swansea,Uk
3731,3732,27/02/2019,CPT,LNK TESCO FABIAN W,20.0,,11596.35,Cash,Swansea,Uk
3732,3733,26/02/2019,BP,SAVE THE CHANGE,1.79,,11616.35,Savings,Swansea,Uk
3733,3734,25/02/2019,DEB,NON-GBP PURCH FEE,0.5,,11618.14,Others,Swansea,Uk
3734,3735,25/02/2019,DEB,NON-GBP TRANS FEE,11.52,,11618.64,Others,Swansea,Uk
3735,3736,25/02/2019,DEB,VEGAN LAUNCH,385.59,,11630.16,Dine Out,,
3736,3737,25/02/2019,DEB,Amazon.co.uk*MI64R,12.37,,12015.75,Amazon,Swansea,Uk
3737,3738,25/02/2019,DEB,AMZN MKTP UK*MI4CC,8.99,,12028.12,Amazon,Swansea,Uk
3738,3739,25/02/2019,DEB,AMZN Mktp UK*MI93A,5.99,,12037.11,Amazon,Swansea,Uk
3739,3740,25/02/2019,DEB,SHARE DEALINGS LEE,5000.0,,12043.1,Services,Swansea,Uk
3740,3741,25/02/2019,DEB,Brontosaurus Vegan,20.99,,17043.1,Dine Out,Swansea,Uk
3741,3742,25/02/2019,DEB,POUNDSTRETCHER 270,4.29,,17064.09,Groceries,,
3742,3743,25/02/2019,DEB,Audible.co.uk,7.99,,17068.38,Entertainment,Swansea,Uk
3743,3744,25/02/2019,DEB,SHARE DEALINGS LEE,25.0,,17076.37,Services,Swansea,Uk
3744,3745,25/02/2019,CPT,LNK TESCO FABIAN W,40.0,,17101.37,Cash,Swansea,Uk
3745,3746,22/02/2019,DEB,SAINSBURY'S S/MKT,11.0,,17141.37,Groceries,,
3746,3747,22/02/2019,CPT,LNK TESCO FABIAN W,40.0,,17152.37,Cash,Swansea,Uk
3747,3748,22/02/2019,DD,CORGI HOMEPLAN,14.75,,17192.37,Home Improvement,Swansea,Uk
3748,3749,21/02/2019,DD,VIRGIN MEDIA PYMTS,29.0,,17207.12,Bills,Swansea,Uk
3749,3750,19/02/2019,CPT,LNK FABIAN WAY,50.0,,17236.12,Cash,Swansea,Uk
3750,3751,19/02/2019,BP,SAVE THE CHANGE,0.66,,17286.12,Savings,Swansea,Uk
3751,3752,18/02/2019,DEB,ZARA SWANSEA,49.99,,17286.78,Clothes,Swansea,Uk
3752,3753,18/02/2019,DEB,Brontosaurus Vegan,12.66,,17336.77,Dine Out,Swansea,Uk
3753,3754,18/02/2019,DEB,AMZN Mktp UK*MI3BZ,11.99,,17349.43,Amazon,Swansea,Uk
3754,3755,18/02/2019,DEB,MARKS&SPENCER PLC,8.7,,17361.42,Clothes,,
3755,3756,18/02/2019,DD,O2,17.95,,17370.12,Other Shopping,Swansea,Uk
3756,3757,18/02/2019,BP,SAVE THE CHANGE,0.57,,17388.07,Savings,Swansea,Uk
3757,3758,15/02/2019,DEB,AMZN Mktp UK*MI5TU,8.43,,17388.64,Amazon,Swansea,Uk
3758,3759,15/02/2019,CPT,LNK TESCO FABIAN W,50.0,,17397.07,Cash,Swansea,Uk
3759,3760,13/02/2019,BP,SAVE THE CHANGE,0.64,,17447.07,Savings,Swansea,Uk
3760,3761,12/02/2019,DEB,AMZN MKTP UK*MI4ED,8.37,,17447.71,Amazon,Swansea,Uk
3761,3762,12/02/2019,DEB,AMZN Mktp UK*MI5RP,7.99,,17456.08,Amazon,Swansea,Uk
3762,3763,12/02/2019,CPT,LNK UNI - UNIVERSI,50.0,,17464.07,Cash,Swansea,Uk
3763,3764,12/02/2019,BP,SAVE THE CHANGE,1.45,,17514.07,Savings,Swansea,Uk
3764,3765,11/02/2019,DEB,AMAZON.CO.UK*MI5QA,7.86,,17515.52,Amazon,Swansea,Uk
3765,3766,11/02/2019,DEB,Brontosaurus Vegan,23.62,,17523.38,Dine Out,Swansea,Uk
3766,3767,11/02/2019,DEB,IQRA SWANSEA LIMIT,20.97,,17547.0,,,
3767,3768,11/02/2019,DEB,MARKS&SPENCER PLC,8.1,,17567.97,Clothes,,
3768,3769,11/02/2019,DEB,POUNDLAND LTD 1414,4.0,,17576.07,Groceries,,
3769,3770,08/02/2019,DD,LV LIFE,37.12,,17580.07,Insurance,Swansea,Uk
3770,3771,08/02/2019,BP,SAVE THE CHANGE,0.87,,17617.19,Savings,Swansea,Uk
3771,3772,07/02/2019,DEB,POUNDSTRETCHER 270,7.13,,17618.06,Groceries,,
3772,3773,07/02/2019,CPT,LNK TESCO FABIAN W,60.0,,17625.19,Cash,Swansea,Uk
3773,3774,07/02/2019,BP,SAVE THE CHANGE,0.85,,17685.19,Savings,Swansea,Uk
3774,3775,06/02/2019,DEB,SAINSBURY'S S/MKT,22.15,,17686.04,Groceries,,
3775,3776,06/02/2019,BP,SAVE THE CHANGE,0.61,,17708.19,Savings,Swansea,Uk
3776,3777,05/02/2019,DEB,AMZN Mktp UK*MI47S,2.39,,17708.8,Amazon,Swansea,Uk
3777,3778,05/02/2019,CPT,LNK FABIAN WAY,50.0,,17711.19,Cash,Swansea,Uk
3778,3779,05/02/2019,BP,SAVE THE CHANGE,0.67,,17761.19,Savings,Swansea,Uk
3779,3780,04/02/2019,DEP,CLUB LLOYDS WAIVED,,3.0,17761.86,Dine Out,Swansea,Uk
3780,3781,04/02/2019,PAY,CLUB LLOYDS FEE,3.0,,17758.86,Bills,Swansea,Uk
3781,3782,04/02/2019,DEB,Brontosaurus Vegan,26.73,,17761.86,Supplementary Income,Swansea,Uk
3782,3783,04/02/2019,DEB,MARKS&SPENCER PLC,13.6,,17788.59,Clothes,,
3783,3784,04/02/2019,DD,ASSURANT INTER LTD,21.15,,17802.19,Insurance,Swansea,Uk
3784,3785,04/02/2019,BP,SAVE THE CHANGE,0.33,,17823.34,Savings,Swansea,Uk
3785,3786,01/02/2019,,INTEREST (GROSS),,6.12,17823.67,Interest,Swansea,Uk
3786,3787,01/02/2019,DEB,TESCO STORES 4628,2.67,,17817.55,Groceries,,
3787,3788,01/02/2019,DD,PRINCIPALITY BS,957.26,,17820.22,Mortgage,Swansea,Uk
3788,3789,01/02/2019,DD,GOOD ENERGY LTD,97.0,,18777.48,Bills,Swansea,Uk
3789,3790,01/02/2019,DD,AVIVA LIFE,46.46,,18874.48,Insurance,Swansea,Uk
3790,3791,01/02/2019,DD,DWR CYMRU W WATER,23.5,,18920.94,Bills,Swansea,Uk
3791,3792,01/02/2019,DD,ZURICH,20.69,,18944.44,Insurance,Swansea,Uk
3792,3793,01/02/2019,DD,CC SWANSEA C.TAX,13.81,,18965.13,Bills,Swansea,Uk
3793,3794,01/02/2019,SO,ESAVINGS ACCOUNT,300.0,,18978.94,Savings,Swansea,Uk
3794,3795,01/02/2019,BP,SAVE THE CHANGE,0.8,,19278.94,Savings,Swansea,Uk
3795,3796,31/01/2019,DEB,BIRMINGHAM INT HOT,47.0,,19279.74,Hotels,Birmingham,Uk
3796,3797,31/01/2019,DEB,WASABI BIRMINGHAM,12.2,,19326.74,Dine Out,Birmingham,Uk
3797,3798,31/01/2019,CPT,LNK TESCO FABIAN W,60.0,,19338.94,Cash,Swansea,Uk
3798,3799,31/01/2019,DD,UCU B ACCOUNT,24.26,,19398.94,Others,Swansea,Uk
3799,3800,31/01/2019,BP,SAVE THE CHANGE,1.0,,19423.2,Savings,Swansea,Uk
3800,3801,31/01/2019,BGC,SWANSEA UNI - PAY,,3251.36,19424.2,Paycheck,Swansea,Uk
3801,3802,30/01/2019,DEB,TFW RAIL SERVICES,67.4,,16172.84,Travel,,
3802,3803,30/01/2019,DEB,SHREWSBURY STARBUC,8.6,,16240.24,Dine Out,Shrewsbury,Uk
3803,3804,30/01/2019,DEB,THE BIKE HUB,5.0,,16248.84,Other Shopping,,
3804,3805,29/01/2019,CPT,LOYD LOYD 802 OXFO,60.0,,16253.84,Cash,Swansea,Uk
3805,3806,29/01/2019,BP,SAVE THE CHANGE,0.8,,16313.84,Savings,Swansea,Uk
3806,3807,28/01/2019,DEB,MARKS&SPENCER PLC,10.2,,16314.64,Clothes,,
3807,3808,28/01/2019,BP,SAVE THE CHANGE,0.1,,16324.84,Savings,Swansea,Uk
3808,3809,25/01/2019,DEB,SAINSBURY'S S/MKT,12.9,,16324.94,Groceries,,
3809,3810,25/01/2019,CPT,LNK TESCO FABIAN W,60.0,,16337.84,Cash,Swansea,Uk
3810,3811,25/01/2019,BP,SAVE THE CHANGE,0.01,,16397.84,Savings,Swansea,Uk
3811,3812,24/01/2019,DEB,Audible.co.uk,7.99,,16397.85,Entertainment,Swansea,Uk
3812,3813,24/01/2019,BP,SAVE THE CHANGE,0.5,,16405.84,Savings,Swansea,Uk
3813,3814,23/01/2019,DEB,HOLIDAY INNS,96.0,,16406.34,Hotels,,
3814,3815,23/01/2019,DEB,HOLIDAY INNS,3.5,,16502.34,Hotels,,
3815,3816,23/01/2019,BP,SAVE THE CHANGE,0.9,,16505.84,Savings,Swansea,Uk
3816,3817,22/01/2019,DEB,LUL TICKET MACHINE,13.1,,16506.74,Travel,London,Uk
3817,3818,22/01/2019,DD,CORGI HOMEPLAN,14.75,,16519.84,Home Improvement,Swansea,Uk
3818,3819,22/01/2019,BP,SAVE THE CHANGE,2.36,,16534.59,Savings,Swansea,Uk
3819,3820,21/01/2019,DEB,PIZZA EXPRESS,27.45,,16536.95,Dine Out,,
3820,3821,21/01/2019,DEB,Brontosaurus Vegan,20.89,,16564.4,Dine Out,Swansea,Uk
3821,3822,21/01/2019,DEB,MARKS&SPENCER PLC,13.2,,16585.29,Clothes,,
3822,3823,21/01/2019,DEB,COFFEE#1 SWANSEA,6.6,,16598.49,Dine Out,Swansea,Uk
3823,3824,21/01/2019,DEB,TESCO STORES 4628,6.5,,16605.09,Groceries,,
3824,3825,21/01/2019,DD,VIRGIN MEDIA PYMTS,29.0,,16611.59,Bills,Swansea,Uk
3825,3826,21/01/2019,CPT,LNK BEST ONE,40.0,,16640.59,Cash,,
3826,3827,18/01/2019,CPT,LNK TESCO FABIAN W,60.0,,16680.59,Cash,Swansea,Uk
3827,3828,18/01/2019,BP,SAVE THE CHANGE,0.3,,16740.59,Savings,Swansea,Uk
3828,3829,17/01/2019,DEB,GWR WEBSALES,116.7,,16740.89,Travel,,
3829,3830,16/01/2019,DD,O2,16.78,,16857.59,Other Shopping,Swansea,Uk
3830,3831,16/01/2019,BP,SAVE THE CHANGE,0.33,,16874.37,Savings,Swansea,Uk
3831,3832,15/01/2019,CPT,LNK TESCO FABIAN W,60.0,,16874.7,Cash,Swansea,Uk
3832,3833,15/01/2019,DEB,SAINSBURYS S/MKTS,30.0,,16934.7,Groceries,,
3833,3834,15/01/2019,DEB,NON-GBP PURCH FEE,0.5,,16964.7,Others,Swansea,Uk
3834,3835,15/01/2019,DEB,NON-GBP TRANS FEE,0.58,,16965.2,Others,Swansea,Uk
3835,3836,15/01/2019,DEB,RMV CONTACT CENTER,19.67,,16965.78,Others,Swansea,Uk
3836,3837,15/01/2019,BP,SAVE THE CHANGE,0.39,,16985.45,Savings,Swansea,Uk
3837,3838,14/01/2019,DEB,Brontosaurus Vegan,23.61,,16985.84,Dine Out,Swansea,Uk
3838,3839,14/01/2019,BP,REMUS MANAGEMENTV2,126.69,,17009.45,Clothes,,
3839,3840,11/01/2019,CPT,LNK TESCO FABIAN W,60.0,,17136.14,Cash,Swansea,Uk
3840,3841,11/01/2019,DD,LV LIFE,37.12,,17196.14,Insurance,Swansea,Uk
3841,3842,08/01/2019,BP,SAVE THE CHANGE,0.79,,17233.26,Savings,Swansea,Uk
3842,3843,07/01/2019,DEB,Brontosaurus Vegan,21.41,,17234.05,Dine Out,Swansea,Uk
3843,3844,07/01/2019,DEB,NON-GBP PURCH FEE,0.5,,17255.46,Others,Swansea,Uk
3844,3845,07/01/2019,DEB,NON-GBP TRANS FEE,4.18,,17255.96,Others,Swansea,Uk
3845,3846,07/01/2019,DEB,ART VILLA NAUTILUS,140.0,,17260.14,Hotels,Santa cruz de tenerife,Spain
3846,3847,07/01/2019,DEB,GWR BRISTOL TM SST,28.8,,17400.14,Travel,Bristol,Uk
3847,3848,07/01/2019,CPT,LOYD LOYD 802 OXFO,60.0,,17428.94,Cash,Swansea,Uk
3848,3849,03/01/2019,DEP,CLUB LLOYDS WAIVED,,3.0,17488.94,Insurance,Swansea,Uk
3849,3850,03/01/2019,PAY,CLUB LLOYDS FEE,3.0,,17485.94,Bills,Swansea,Uk
3850,3851,03/01/2019,DD,ASSURANT INTER LTD,21.15,,17488.94,Supplementary Income,Swansea,Uk
3851,3852,03/01/2019,DD,ZURICH,20.69,,17510.09,Insurance,Swansea,Uk
3852,3853,02/01/2019,,INTEREST (GROSS),,6.12,17530.78,Interest,Swansea,Uk
3853,3854,02/01/2019,DD,PRINCIPALITY BS,957.26,,17524.66,Mortgage,Swansea,Uk
3854,3855,02/01/2019,DD,GOOD ENERGY LTD,97.0,,18481.92,Bills,Swansea,Uk
3855,3856,02/01/2019,DD,AVIVA LIFE,46.46,,18578.92,Insurance,Swansea,Uk
3856,3857,02/01/2019,DD,DWR CYMRU W WATER,23.5,,18625.38,Bills,Swansea,Uk
3857,3858,02/01/2019,SO,ESAVINGS ACCOUNT,300.0,,18648.88,Savings,Swansea,Uk
3858,3859,31/12/2018,DD,UCU B ACCOUNT,24.26,,18948.88,Others,Swansea,Uk
3859,3860,31/12/2018,BP,SAVE THE CHANGE,0.6,,18973.14,Savings,Swansea,Uk
3860,3861,31/12/2018,BGC,SWANSEA UNI - PAY,,3251.36,18973.74,Paycheck,Swansea,Uk
3861,3862,28/12/2018,DEB,TFW RAIL SERVICES,8.4,,15722.38,Travel,,
3862,3863,28/12/2018,BP,SAVE THE CHANGE,1.79,,15730.78,Savings,Swansea,Uk
3863,3864,27/12/2018,DEB,NON-GBP PURCH FEE,0.5,,15732.57,Others,Swansea,Uk
3864,3865,27/12/2018,DEB,NON-GBP TRANS FEE,1.34,,15733.07,Others,Swansea,Uk
3865,3866,27/12/2018,DEB,Hotel on Booking.c,45.14,,15734.41,Hotels,,
3866,3867,27/12/2018,DEB,FRANCESCO LEONE,147.73,,15779.55,Services,Swansea,Uk
3867,3868,27/12/2018,DEB,NON-GBP PURCH FEE,0.5,,15927.28,Others,Swansea,Uk
3868,3869,27/12/2018,DEB,NON-GBP TRANS FEE,0.39,,15927.78,Others,Swansea,Uk
3869,3870,27/12/2018,DEB,COVIRAN LOS ABRIGO,13.34,,15928.17,Groceries,Santa cruz de tenerife,Spain
3870,3871,27/12/2018,BP,SAVE THE CHANGE,1.77,,15941.51,Savings,Swansea,Uk
3871,3872,24/12/2018,DEB,AMZN Mktp UK*M2882,2.71,,15943.28,Amazon,Swansea,Uk
3872,3873,24/12/2018,DEB,Audible.co.uk,7.99,,15945.99,Entertainment,Swansea,Uk
3873,3874,24/12/2018,DEB,Brontosaurus Vegan,12.98,,15953.98,Dine Out,Swansea,Uk
3874,3875,24/12/2018,DEB,POST OFFICE SELF S,24.35,,15966.96,Others,Swansea,Uk
3875,3876,24/12/2018,DEB,SAINSBURY'S S/MKT,20.5,,15991.31,Groceries,,
3876,3877,24/12/2018,DEB,MARKS&SPENCER PLC,2.7,,16011.81,Clothes,,
3877,3878,24/12/2018,DD,CORGI HOMEPLAN,14.75,,16014.51,Home Improvement,Swansea,Uk
3878,3879,24/12/2018,BGC,SWANSEA UNIVERSITY,,516.6,16029.26,Supplementary Income,Swansea,Uk
3879,3880,24/12/2018,CPT,LNK M&S SWANSEA,40.0,,15512.66,Cash,Swansea,Uk
3880,3881,21/12/2018,CPT,P.O. 37 THE QUADAN,99.01,,15552.66,Entertainment,Swansea,Uk
3881,3882,21/12/2018,DD,VIRGIN MEDIA PYMTS,29.0,,15651.67,Bills,Nottingham,Uk
3882,3883,20/12/2018,BP,SAVE THE CHANGE,0.2,,15680.67,Savings,Swansea,Uk
3883,3884,19/12/2018,DEB,SAINSBURY'S S/MKT,24.8,,15680.87,Groceries,,
3884,3885,19/12/2018,CPT,LNK TESCO FABIAN W,60.0,,15705.67,Cash,Swansea,Uk
3885,3886,19/12/2018,BP,SAVE THE CHANGE,0.09,,15765.67,Savings,Swansea,Uk
3886,3887,18/12/2018,DEB,Amazon.co.uk*M23Q2,5.91,,15765.76,Amazon,Swansea,Uk
3887,3888,18/12/2018,BP,SAVE THE CHANGE,1.26,,15771.67,Savings,Swansea,Uk
3888,3889,17/12/2018,DEB,TUI,259.0,,15772.93,Travel,,
3889,3890,17/12/2018,DEB,TUI,84.0,,16031.93,Travel,,
3890,3891,17/12/2018,DEB,DEBENHAMS,72.0,,16115.93,Other Shopping,,
3891,3892,17/12/2018,DEB,HOSTEL WORLD,22.24,,16187.93,Hotels,,
3892,3893,17/12/2018,DEB,TFW RAIL SERVICES,11.5,,16210.17,Travel,,
3893,3894,17/12/2018,DD,O2,18.5,,16221.67,Other Shopping,Swansea,Uk
3894,3895,17/12/2018,CPT,LNK ARRIVA TRAINS,50.0,,16240.17,Cash,,
3895,3896,14/12/2018,DEB,TESCO STORES 4628,11.0,,16290.17,Groceries,,
3896,3897,14/12/2018,BGC,SWANSEA UNIVERSITY,,939.47,16301.17,Supplementary Income,Swansea,Uk
3897,3898,13/12/2018,DEB,EUROPEAN MOVING,230.0,,15361.7,Others,Swansea,Uk
3898,3899,13/12/2018,CPT,LNK TESCO FABIAN W,60.0,,15591.7,Cash,Swansea,Uk
3899,3900,11/12/2018,BP,SAVE THE CHANGE,0.51,,15651.7,Savings,Swansea,Uk
3900,3901,10/12/2018,CPT,LNK TESCO FABIAN W,40.0,,15652.21,Cash,Swansea,Uk
3901,3902,10/12/2018,DEB,MOUNTAIN WAREHOUSE,49.99,,15692.21,Other Shopping,Leicester,Uk
3902,3903,10/12/2018,DEB,TFW RAIL SERVICES,11.5,,15742.2,Travel,,
3903,3904,10/12/2018,DD,LV LIFE,37.12,,15753.7,Insurance,Swansea,Uk
3904,3905,10/12/2018,CPT,LNK CARDIFF 1,40.0,,15790.82,Cash,Cardiff,Uk
3905,3906,06/12/2018,CPT,LNK TESCO FABIAN W,60.0,,15830.82,Cash,Swansea,Uk
3906,3907,06/12/2018,BP,SAVE THE CHANGE,1.11,,15890.82,Savings,Swansea,Uk
3907,3908,05/12/2018,DEB,EUROPEAN MOVING,511.7,,15891.93,Others,Swansea,Uk
3908,3909,05/12/2018,DEB,AMAZON.CO.UK*M005N,4.19,,16403.63,Amazon,Swansea,Uk
3909,3910,05/12/2018,BP,SAVE THE CHANGE,0.04,,16407.82,Savings,Swansea,Uk
3910,3911,04/12/2018,DEP,CLUB LLOYDS WAIVED,,3.0,16407.86,Amazon,Swansea,Uk
3911,3912,04/12/2018,PAY,CLUB LLOYDS FEE,3.0,,16404.86,Bills,Swansea,Uk
3912,3913,04/12/2018,DEB,AMZN MKTP UK*M04GF,3.96,,16407.86,Supplementary Income,Swansea,Uk
3913,3914,04/12/2018,CPT,LNK TESCO FABIAN W,40.0,,16411.82,Cash,Swansea,Uk
3914,3915,04/12/2018,BP,SAVE THE CHANGE,0.9,,16451.82,Savings,Swansea,Uk
3915,3916,03/12/2018,,INTEREST (GROSS),,6.53,16452.72,Interest,Swansea,Uk
3916,3917,03/12/2018,DEB,AMAZON.CO.UK*M050B,22.6,,16446.19,Amazon,Swansea,Uk
3917,3918,03/12/2018,DEB,SAINSBURYS S/MKTS,22.5,,16468.79,Groceries,,
3918,3919,03/12/2018,DD,PRINCIPALITY BS,957.26,,16491.29,Mortgage,Swansea,Uk
3919,3920,03/12/2018,DD,CC SWANSEA C.TAX,184.0,,17448.55,Bills,Swansea,Uk
3920,3921,03/12/2018,DD,GOOD ENERGY LTD,97.0,,17632.55,Bills,Swansea,Uk
3921,3922,03/12/2018,DD,AVIVA LIFE,46.46,,17729.55,Insurance,Swansea,Uk
3922,3923,03/12/2018,DD,DWR CYMRU W WATER,23.5,,17776.01,Bills,Swansea,Uk
3923,3924,03/12/2018,DD,ASSURANT INTER LTD,21.15,,17799.51,Insurance,Swansea,Uk
3924,3925,03/12/2018,DD,ZURICH,20.69,,17820.66,Insurance,Swansea,Uk
3925,3926,03/12/2018,SO,ESAVINGS ACCOUNT,300.0,,17841.35,Savings,Swansea,Uk
3926,3927,03/12/2018,BP,SAVE THE CHANGE,0.55,,18141.35,Savings,Swansea,Uk
3927,3928,03/12/2018,CPT,LOYD LOYD 802 OXFO,50.0,,18141.9,Cash,Swansea,Uk
3928,3929,30/11/2018,DEB,LAS IGUNAS,36.45,,18191.9,Dine Out,,
3929,3930,30/11/2018,DD,UCU B ACCOUNT,24.26,,18228.35,Others,Swansea,Uk
3930,3931,30/11/2018,BGC,SWANSEA UNI - PAY,,3251.36,18252.61,Paycheck,Swansea,Uk
3931,3932,29/11/2018,CPT,LNK PO THE CITYOFS,50.0,,15001.25,Cash,,
3932,3933,27/11/2018,BP,SAVE THE CHANGE,1.35,,15051.25,Savings,Swansea,Uk
3933,3934,26/11/2018,DEB,EASYJET   EVXNX8,32.0,,15052.6,Travel,,
3934,3935,26/11/2018,DEB,WILKO RETAIL LIMIT,23.0,,15084.6,Other Shopping,,
3935,3936,26/11/2018,DEB,AMAZON.CO.UK*M83AN,11.85,,15107.6,Amazon,Swansea,Uk
3936,3937,26/11/2018,DEB,AMZN MKTP UK*M849V,49.98,,15119.45,Amazon,Swansea,Uk
3937,3938,26/11/2018,DEB,Brontosaurus Vegan,33.6,,15169.43,Dine Out,Swansea,Uk
3938,3939,26/11/2018,DEB,AMAZON.CO.UK*M83UY,3.23,,15203.03,Amazon,Swansea,Uk
3939,3940,26/11/2018,DEB,Audible.co.uk,7.99,,15206.26,Entertainment,Swansea,Uk
3940,3941,26/11/2018,CPT,LNK UNI - UNIVERSI,80.0,,15214.25,Cash,Swansea,Uk
3941,3942,23/11/2018,CPT,LNK TESCO FABIAN W,40.0,,15294.25,Cash,Swansea,Uk
3942,3943,22/11/2018,DD,CORGI HOMEPLAN,14.75,,15334.25,Home Improvement,Swansea,Uk
3943,3944,22/11/2018,BP,SAVE THE CHANGE,1.06,,15349.0,Savings,Swansea,Uk
3944,3945,21/11/2018,DEB,AMZN Mktp UK*M85HN,8.88,,15350.06,Amazon,Swansea,Uk
3945,3946,21/11/2018,DEB,Amazon.co.uk*M88N5,4.33,,15358.94,Amazon,Swansea,Uk
3946,3947,21/11/2018,CPT,LNK TESCO FABIAN W,40.0,,15363.27,Cash,Swansea,Uk
3947,3948,21/11/2018,DD,VIRGIN MEDIA PYMTS,29.0,,15403.27,Bills,Nottingham,Uk
3948,3949,21/11/2018,DEB,NON-GBP PURCH FEE,0.5,,15432.27,Others,Swansea,Uk
3949,3950,21/11/2018,DEB,NON-GBP TRANS FEE,1.06,,15432.77,Others,Swansea,Uk
3950,3951,21/11/2018,DEB,KLM*REF UGUA8R OPT,35.73,,15433.83,Travel,,
3951,3952,21/11/2018,BP,SAVE THE CHANGE,0.35,,15469.56,Savings,Swansea,Uk
3952,3953,20/11/2018,DEB,NON-GBP PURCH FEE,0.5,,15469.91,Others,Swansea,Uk
3953,3954,20/11/2018,DEB,NON-GBP TRANS FEE,6.75,,15470.41,Others,Swansea,Uk
3954,3955,20/11/2018,DEB,SCHLOSS DAGSTUHL -,225.81,,15477.16,Entertainment,,
3955,3956,20/11/2018,DEB,NON-GBP PURCH FEE,0.5,,15702.97,Others,Swansea,Uk
3956,3957,20/11/2018,DEB,NON-GBP TRANS FEE,2.47,,15703.47,Others,Swansea,Uk
3957,3958,20/11/2018,DEB,SCHLOSS DAGSTUHL -,82.84,,15705.94,Entertainment,,
3958,3959,20/11/2018,BP,SAVE THE CHANGE,0.6,,15788.78,Savings,Swansea,Uk
3959,3960,19/11/2018,DEB,Brontosaurus Vegan,24.41,,15789.38,Dine Out,Swansea,Uk
3960,3961,19/11/2018,DEB,CANDLES & CO,21.99,,15813.79,Other Shopping,,
3961,3962,19/11/2018,CPT,LNK M&S SWANSEA,80.0,,15835.78,Cash,Swansea,Uk
3962,3963,16/11/2018,DD,O2,19.45,,15915.78,Other Shopping,Swansea,Uk
3963,3964,15/11/2018,BP,SAVE THE CHANGE,0.03,,15935.23,Savings,Swansea,Uk
3964,3965,14/11/2018,DEB,NON-GBP PURCH FEE,0.5,,15935.26,Others,Swansea,Uk
3965,3966,14/11/2018,DEB,NON-GBP TRANS FEE,1.76,,15935.76,Others,Swansea,Uk
3966,3967,14/11/2018,DEB,DB AUTOMATEN,58.97,,15937.52,Travel,,
3967,3968,14/11/2018,BP,SAVE THE CHANGE,0.17,,15996.49,Savings,Swansea,Uk
3968,3969,13/11/2018,DEB,KLM UNITEDKI074822,34.83,,15996.66,Travel,,
3969,3970,13/11/2018,BP,SAVE THE CHANGE,0.8,,16031.49,Savings,Swansea,Uk
3970,3971,12/11/2018,DEB,ARRIVA TRAINS WALE,38.2,,16032.29,Travel,,
3971,3972,12/11/2018,CPT,LNK ARRIVA TRAINS,40.0,,16070.49,Cash,,
3972,3973,12/11/2018,CPT,LNK M&S SWANSEA,60.0,,16110.49,Cash,Swansea,Uk
3973,3974,09/11/2018,DD,LV LIFE,37.12,,16170.49,Insurance,Swansea,Uk
3974,3975,07/11/2018,CPT,LNK TESCO FABIAN W,60.0,,16207.61,Cash,Swansea,Uk
3975,3976,05/11/2018,DD,ASSURANT INTER LTD,21.15,,16267.61,Insurance,Swansea,Uk
3976,3977,02/11/2018,DEP,CLUB LLOYDS WAIVED,,3.0,16288.76,Supplementary Income,Swansea,Uk
3977,3978,02/11/2018,PAY,CLUB LLOYDS FEE,3.0,,16285.76,Bills,Swansea,Uk
3978,3979,02/11/2018,BGC,SWANSEA UNIVERSITY,,105.6,16288.76,Supplementary Income,Swansea,Uk
3979,3980,01/11/2018,,INTEREST (GROSS),,6.33,16183.16,Interest,Swansea,Uk
3980,3981,01/11/2018,DD,PRINCIPALITY BS,957.26,,16176.83,Mortgage,Swansea,Uk
3981,3982,01/11/2018,DD,CC SWANSEA C.TAX,184.0,,17134.09,Bills,Swansea,Uk
3982,3983,01/11/2018,DD,GOOD ENERGY LTD,97.0,,17318.09,Bills,Swansea,Uk
3983,3984,01/11/2018,DD,AVIVA LIFE,46.46,,17415.09,Insurance,Swansea,Uk
3984,3985,01/11/2018,DD,DWR CYMRU W WATER,23.5,,17461.55,Bills,Swansea,Uk
3985,3986,01/11/2018,DD,ZURICH,20.69,,17485.05,Insurance,Swansea,Uk
3986,3987,01/11/2018,SO,ESAVINGS ACCOUNT,300.0,,17505.74,Savings,Swansea,Uk
3987,3988,31/10/2018,DD,UCU B ACCOUNT,24.26,,17805.74,Others,Swansea,Uk
3988,3989,31/10/2018,BP,SAVE THE CHANGE,0.87,,17830.0,Savings,Swansea,Uk
3989,3990,31/10/2018,BGC,SWANSEA UNI - PAY,,3251.36,17830.87,Paycheck,Swansea,Uk
3990,3991,30/10/2018,DEB,SWANSEA UNI - CATE,4.5,,14579.51,Dine Out,Swansea,Uk
3991,3992,30/10/2018,CHQ,LOYD 802 OXFORD ST,,1383.0,14584.01,Supplementary Income,Swansea,Uk
3992,3993,30/10/2018,DEB,NON-GBP PURCH FEE,0.5,,13201.01,Others,Swansea,Uk
3993,3994,30/10/2018,DEB,NON-GBP TRANS FEE,22.14,,13201.51,Others,Swansea,Uk
3994,3995,30/10/2018,DEB,ESTREL FRONT OFFIC,740.63,,13223.65,Travel,Berlin,Germany
3995,3996,30/10/2018,BP,SAVE THE CHANGE,1.16,,13964.28,Savings,Swansea,Uk
3996,3997,29/10/2018,DEB,Brontosaurus Vegan,31.34,,13965.44,Dine Out,Swansea,Uk
3997,3998,29/10/2018,DEB,ARRIVA TRAINS WALE,11.5,,13996.78,Travel,,
3998,3999,29/10/2018,CPT,LNK TESCO FABIAN W,40.0,,14008.28,Cash,Swansea,Uk
3999,4000,29/10/2018,CPT,LOYD LOYD 802 OXFO,50.0,,14048.28,Cash,Swansea,Uk
4000,4001,25/10/2018,BP,SAVE THE CHANGE,0.01,,14098.28,Savings,Swansea,Uk
4001,4002,24/10/2018,DEB,Audible.co.uk,7.99,,14098.29,Entertainment,Swansea,Uk
4002,4003,22/10/2018,DD,VIRGIN MEDIA PYMTS,22.4,,14106.28,Bills,Nottingham,Uk
4003,4004,22/10/2018,DD,CORGI HOMEPLAN,14.75,,14128.68,Home Improvement,Swansea,Uk
4004,4005,22/10/2018,BP,SAVE THE CHANGE,1.29,,14143.43,Savings,Swansea,Uk
4005,4006,19/10/2018,DEB,TESCO STORES 4628,12.25,,14144.72,Groceries,,
4006,4007,19/10/2018,DEB,AMZN Mktp UK,3.46,,14156.97,Amazon,Swansea,Uk
4007,4008,19/10/2018,BP,SAVE THE CHANGE,0.35,,14160.43,Savings,Swansea,Uk
4008,4009,18/10/2018,DEB,AMZN Mktp UK,69.99,,14160.78,Amazon,Swansea,Uk
4009,4010,18/10/2018,DEB,AMAZON.CO.UK AMAZO,11.77,,14230.77,Amazon,Swansea,Uk
4010,4011,18/10/2018,DEB,Amazon.co.uk,6.89,,14242.54,Amazon,Swansea,Uk
4011,4012,18/10/2018,CPT,LNK TESCO FABIAN W,50.0,,14249.43,Cash,Swansea,Uk
4012,4013,18/10/2018,BP,SAVE THE CHANGE,0.77,,14299.43,Savings,Swansea,Uk
4013,4014,17/10/2018,DEB,NON-STG PURCH FEE,0.5,,14300.2,Others,Swansea,Uk
4014,4015,17/10/2018,DEB,NON-STG TRANS FEE,1.14,,14300.7,Others,Swansea,Uk
4015,4016,17/10/2018,DEB,WPY*PayIt2com Ragh,38.23,,14301.84,Investment,Nottingham,Uk
4016,4017,16/10/2018,CPT,LNK TESCO FABIAN W,50.0,,14340.07,Cash,Swansea,Uk
4017,4018,16/10/2018,DD,O2,18.5,,14390.07,Other Shopping,Swansea,Uk
4018,4019,16/10/2018,BP,SAVE THE CHANGE,0.01,,14408.57,Savings,Swansea,Uk
4019,4020,15/10/2018,DEB,AMZN Mktp UK,14.99,,14408.58,Amazon,Swansea,Uk
4020,4021,11/10/2018,BP,SAVE THE CHANGE,0.52,,14423.57,Savings,Swansea,Uk
4021,4022,10/10/2018,DEB,EASYJET   EVXNX8,359.9,,14424.09,Travel,,
4022,4023,10/10/2018,DEB,AMZN MKTP UK AMAZO,7.99,,14783.99,Amazon,Swansea,Uk
4023,4024,10/10/2018,DEB,AMZN MKTP UK AMAZO,7.59,,14791.98,Amazon,Swansea,Uk
4024,4025,10/10/2018,TFR,F/FLOW KATHLEEN M,,721.25,14799.57,Supplementary Income,Swansea,Uk
4025,4026,09/10/2018,FPI,MARIANA MILLS,,180.0,14078.32,Supplementary Income,Swansea,Uk
4026,4027,09/10/2018,BP,SAVE THE CHANGE,0.49,,13898.32,Savings,Swansea,Uk
4027,4028,08/10/2018,DEB,AMZN Mktp UK,5.51,,13898.81,Amazon,Swansea,Uk
4028,4029,08/10/2018,CPT,LNK UNI - UNIVERSI,100.0,,13904.32,Cash,Swansea,Uk
4029,4030,08/10/2018,DD,LV LIFE,37.12,,14004.32,Insurance,Swansea,Uk
4030,4031,08/10/2018,CPT,LNK M&S SWANSEA,100.0,,14041.44,Cash,Swansea,Uk
4031,4032,05/10/2018,CPT,LNK UNI - UNIVERSI,50.0,,14141.44,Cash,Swansea,Uk
4032,4033,05/10/2018,BP,SAVE THE CHANGE,0.35,,14191.44,Savings,Swansea,Uk
4033,4034,04/10/2018,DEB,DELIVEROO.CO.UK,24.65,,14191.79,Dine Out,,
4034,4035,03/10/2018,DD,ASSURANT INTER LTD,21.15,,14216.44,Insurance,Swansea,Uk
4035,4036,03/10/2018,BP,SAVE THE CHANGE,0.01,,14237.59,Savings,Swansea,Uk
4036,4037,02/10/2018,DEP,CLUB LLOYDS WAIVED,,3.0,14237.6,Amazon,Swansea,Uk
4037,4038,02/10/2018,PAY,CLUB LLOYDS FEE,3.0,,14234.6,Bills,Swansea,Uk
4038,4039,02/10/2018,DEB,Amazon.co.uk,14.99,,14237.6,Supplementary Income,Swansea,Uk
4039,4040,02/10/2018,BP,SAVE THE CHANGE,3.25,,14252.59,Savings,Swansea,Uk
4040,4041,01/10/2018,,INTEREST (GROSS),,5.71,14255.84,Interest,Swansea,Uk
4041,4042,01/10/2018,DEB,AMZN Mktp UK,23.88,,14250.13,Amazon,Swansea,Uk
4042,4043,01/10/2018,DEB,AMZN Mktp UK,4.49,,14274.01,Amazon,Swansea,Uk
4043,4044,01/10/2018,DEB,Brontosaurus Vegan,37.29,,14278.5,Dine Out,Swansea,Uk
4044,4045,01/10/2018,DEB,GOOGLE *YouTube Vi,3.49,,14315.79,,,
4045,4046,01/10/2018,DEB,ARRIVA TRAINS WALE,75.1,,14319.28,Travel,,
4046,4047,01/10/2018,DEB,WASABI BIRMINGHAM,30.5,,14394.38,Dine Out,Birmingham,Uk
4047,4048,01/10/2018,DEB,easyHotel Birmingh,10.0,,14424.88,Hotels,Birmingham,Uk
4048,4049,01/10/2018,DD,PRINCIPALITY BS,957.26,,14434.88,Mortgage,Swansea,Uk
4049,4050,01/10/2018,DD,CC SWANSEA C.TAX,184.0,,15392.14,Bills,Swansea,Uk
4050,4051,01/10/2018,DD,GOOD ENERGY LTD,97.0,,15576.14,Bills,Swansea,Uk
4051,4052,01/10/2018,DD,AVIVA LIFE,46.46,,15673.14,Insurance,Swansea,Uk
4052,4053,01/10/2018,DD,DWR CYMRU W WATER,23.5,,15719.6,Bills,Swansea,Uk
4053,4054,01/10/2018,DD,ZURICH,20.69,,15743.1,Insurance,Swansea,Uk
4054,4055,01/10/2018,SO,ESAVINGS ACCOUNT,300.0,,15763.79,Savings,Swansea,Uk
4055,4056,01/10/2018,CPT,LNK MORRISONS SWAN,50.0,,16063.79,Cash,Swansea,Uk
4056,4057,28/09/2018,DD,UCU B ACCOUNT,24.26,,16113.79,Others,Swansea,Uk
4057,4058,28/09/2018,BGC,SWANSEA UNI - PAY,,3250.96,16138.05,Paycheck,Swansea,Uk
4058,4059,26/09/2018,CPT,LNK UNI - UNIVERSI,50.0,,12887.09,Cash,Swansea,Uk
4059,4060,25/09/2018,BP,SAVE THE CHANGE,0.95,,12937.09,Savings,Swansea,Uk
4060,4061,24/09/2018,DEB,Audible.co.uk,7.99,,12938.04,Entertainment,Swansea,Uk
4061,4062,24/09/2018,DEB,Brontosaurus Vegan,43.06,,12946.03,Dine Out,Swansea,Uk
4062,4063,24/09/2018,CPT,LNK MORRISONS SWAN,200.0,,12989.09,Cash,Swansea,Uk
4063,4064,21/09/2018,DD,VIRGIN MEDIA PYMTS,40.0,,13189.09,Bills,Nottingham,Uk
4064,4065,21/09/2018,BP,SAVE THE CHANGE,0.6,,13229.09,Savings,Swansea,Uk
4065,4066,21/09/2018,BGC,SWANSEA UNIVERSITY,,170.74,13229.69,Supplementary Income,Swansea,Uk
4066,4067,20/09/2018,DEB,DELIVEROO.CO.UK,24.4,,13058.95,Dine Out,,
4067,4068,20/09/2018,BP,SAVE THE CHANGE,0.01,,13083.35,Savings,Swansea,Uk
4068,4069,19/09/2018,DEB,Amazon.co.uk,77.0,,13083.36,Amazon,Swansea,Uk
4069,4070,19/09/2018,DEB,easyHotel Birmingh,42.99,,13160.36,Hotels,Birmingham,Uk
4070,4071,19/09/2018,CPT,LNK UNI - UNIVERSI,50.0,,13203.35,Cash,Swansea,Uk
4071,4072,18/09/2018,BP,SAVE THE CHANGE,0.04,,13253.35,Savings,Swansea,Uk
4072,4073,17/09/2018,DEB,AMZN MKTP UK AMAZO,33.96,,13253.39,Amazon,Swansea,Uk
4073,4074,17/09/2018,DD,O2,17.95,,13287.35,Other Shopping,Swansea,Uk
4074,4075,17/09/2018,BP,SAVE THE CHANGE,0.37,,13305.3,Savings,Swansea,Uk
4075,4076,14/09/2018,DEB,AMZN Mktp UK,2.63,,13305.67,Amazon,Swansea,Uk
4076,4077,14/09/2018,BP,SAVE THE CHANGE,0.6,,13308.3,Savings,Swansea,Uk
4077,4078,13/09/2018,DEB,DELIVEROO.CO.UK,24.4,,13308.9,Dine Out,,
4078,4079,13/09/2018,BP,SAVE THE CHANGE,0.25,,13333.3,Savings,Swansea,Uk
4079,4080,12/09/2018,DEB,AMZN Mktp UK,2.75,,13333.55,Amazon,Swansea,Uk
4080,4081,11/09/2018,BP,SAVE THE CHANGE,2.36,,13336.3,Savings,Swansea,Uk
4081,4082,10/09/2018,DEB,SQ *FLOOR & DECOR,341.05,,13338.66,Home Improvement,Swansea,Uk
4082,4083,10/09/2018,DEB,Brontosaurus Vegan,21.51,,13679.71,Dine Out,Swansea,Uk
4083,4084,10/09/2018,DEB,MARKS&SPENCER PLC,11.4,,13701.22,Clothes,,
4084,4085,10/09/2018,DEB,AMZN Mktp UK,8.68,,13712.62,Amazon,Swansea,Uk
4085,4086,10/09/2018,DD,LV LIFE,37.12,,13721.3,Insurance,Swansea,Uk
4086,4087,07/09/2018,BP,SAVE THE CHANGE,0.51,,13758.42,Savings,Swansea,Uk
4087,4088,06/09/2018,DEB,Amazon.co.uk,35.49,,13758.93,Amazon,Swansea,Uk
4088,4089,05/09/2018,DD,ASSURANT INTER LTD,21.3,,13794.42,Insurance,Swansea,Uk
4089,4090,05/09/2018,BP,SAVE THE CHANGE,0.75,,13815.72,Savings,Swansea,Uk
4090,4091,04/09/2018,DEP,CLUB LLOYDS WAIVED,,3.0,13816.47,Amazon,Swansea,Uk
4091,4092,04/09/2018,PAY,CLUB LLOYDS FEE,3.0,,13813.47,Bills,Swansea,Uk
4092,4093,04/09/2018,DEB,AMZN Mktp UK,5.25,,13816.47,Supplementary Income,Swansea,Uk
4093,4094,04/09/2018,BP,SAVE THE CHANGE,1.02,,13821.72,Savings,Swansea,Uk
4094,4095,04/09/2018,BGC,IRG ADVISORS LLP,,345.8,13822.74,Supplementary Income,Swansea,Uk
4095,4096,04/09/2018,BGC,IRG ADVISORS LLP,,116.4,13476.94,Supplementary Income,Swansea,Uk
4096,4097,03/09/2018,,INTEREST (GROSS),,6.74,13360.54,Interest,Swansea,Uk
4097,4098,03/09/2018,DEB,Brontosaurus Vegan,23.53,,13353.8,Dine Out,Swansea,Uk
4098,4099,03/09/2018,DEB,PAYPAL *VIMEO INC,3.45,,13377.33,Services,Swansea,Uk
4099,4100,03/09/2018,DD,PRINCIPALITY BS,957.26,,13380.78,Mortgage,Swansea,Uk
4100,4101,03/09/2018,DD,CC SWANSEA C.TAX,184.0,,14338.04,Bills,Swansea,Uk
4101,4102,03/09/2018,DD,GOOD ENERGY LTD,97.0,,14522.04,Bills,Swansea,Uk
4102,4103,03/09/2018,DD,AVIVA LIFE,46.46,,14619.04,Insurance,Swansea,Uk
4103,4104,03/09/2018,DD,DWR CYMRU W WATER,23.5,,14665.5,Bills,Swansea,Uk
4104,4105,03/09/2018,DD,ZURICH,19.36,,14689.0,Insurance,Swansea,Uk
4105,4106,03/09/2018,SO,ESAVINGS ACCOUNT,300.0,,14708.36,Savings,Swansea,Uk
4106,4107,03/09/2018,BP,SAVE THE CHANGE,0.01,,15008.36,Savings,Swansea,Uk
4107,4108,03/09/2018,FPO,P M GREY,1360.0,,15008.37,Services,Swansea,Uk
4108,4109,31/08/2018,DEB,AMZN Mktp UK,33.99,,16368.37,Amazon,Swansea,Uk
4109,4110,31/08/2018,CPT,LNK UNI - UNIVERSI,40.0,,16402.36,Cash,Swansea,Uk
4110,4111,31/08/2018,DD,UCU B ACCOUNT,23.11,,16442.36,Others,Swansea,Uk
4111,4112,31/08/2018,BGC,SWANSEA UNI - PAY,,3251.36,16465.47,Paycheck,Swansea,Uk
4112,4113,30/08/2018,CPT,LNK UNI - UNIVERSI,50.0,,13214.11,Cash,Swansea,Uk
4113,4114,30/08/2018,BP,SAVE THE CHANGE,0.9,,13264.11,Savings,Swansea,Uk
4114,4115,29/08/2018,DEB,AMZN Mktp UK,7.31,,13265.01,Amazon,Swansea,Uk
4115,4116,29/08/2018,DEB,AMZN Mktp UK,2.79,,13272.32,Amazon,Swansea,Uk
4116,4117,29/08/2018,BP,SAVE THE CHANGE,1.1,,13275.11,Savings,Swansea,Uk
4117,4118,28/08/2018,DEB,AMZN Mktp UK,8.99,,13276.21,Amazon,Swansea,Uk
4118,4119,28/08/2018,DEB,ARRIVA TRAINS WALE,11.5,,13285.2,Travel,,
4119,4120,28/08/2018,DEB,Brontosaurus Vegan,24.41,,13296.7,Dine Out,Swansea,Uk
4120,4121,28/08/2018,CPT,LNK UNI - UNIVERSI,40.0,,13321.11,Cash,Swansea,Uk
4121,4122,28/08/2018,BP,SAVE THE CHANGE,0.16,,13361.11,Savings,Swansea,Uk
4122,4123,28/08/2018,CPT,LNK ARRIVA TRAINS,40.0,,13361.27,Cash,,
4123,4124,24/08/2018,DEB,PIZZA EXPRESS,86.85,,13401.27,Dine Out,,
4124,4125,24/08/2018,DEB,Audible.co.uk,7.99,,13488.12,Entertainment,Swansea,Uk
4125,4126,24/08/2018,CPT,LNK M&S SWANSEA,20.0,,13496.11,Cash,Swansea,Uk
4126,4127,24/08/2018,BGC,SWANSEA UNIVERSITY,,276.32,13516.11,Supplementary Income,Swansea,Uk
4127,4128,22/08/2018,CPT,LNK UNI - UNIVERSI,50.0,,13239.79,Cash,Swansea,Uk
4128,4129,22/08/2018,BP,SAVE THE CHANGE,0.4,,13289.79,Savings,Swansea,Uk
4129,4130,21/08/2018,FPO,P M GREY,3500.0,,13290.19,Services,Swansea,Uk
4130,4131,21/08/2018,DEB,AMZN Mktp UK,7.98,,16790.19,Amazon,Swansea,Uk
4131,4132,21/08/2018,DEB,AMZN Mktp UK,2.62,,16798.17,Amazon,Swansea,Uk
4132,4133,21/08/2018,DD,VIRGIN MEDIA PYMTS,27.0,,16800.79,Bills,Nottingham,Uk
4133,4134,21/08/2018,BP,SAVE THE CHANGE,1.55,,16827.79,Savings,Swansea,Uk
4134,4135,20/08/2018,DEB,AMZN Mktp UK,10.0,,16829.34,Amazon,Swansea,Uk
4135,4136,20/08/2018,DEB,AMZN Mktp UK,7.25,,16839.34,Amazon,Swansea,Uk
4136,4137,20/08/2018,DEB,Brontosaurus Vegan,28.2,,16846.59,Dine Out,Swansea,Uk
4137,4138,20/08/2018,BP,SAVE THE CHANGE,0.9,,16874.79,Savings,Swansea,Uk
4138,4139,20/08/2018,CPT,LNK M&S SWANSEA,50.0,,16875.69,Cash,Swansea,Uk
4139,4140,17/08/2018,DEB,ARRIVA TRAINS WALE,87.1,,16925.69,Travel,,
4140,4141,17/08/2018,DEB,BEAUFORT PARK HOTE,58.0,,17012.79,Hotels,New brighton,Moldova
4141,4142,17/08/2018,BP,SAVE THE CHANGE,1.0,,17070.79,Savings,Swansea,Uk
4142,4143,16/08/2018,DEB,AMZN Mktp UK,5.45,,17071.79,Amazon,Swansea,Uk
4143,4144,16/08/2018,DEB,AMZN Mktp UK,3.55,,17077.24,Amazon,Swansea,Uk
4144,4145,16/08/2018,CPT,LNK UNI - UNIVERSI,60.0,,17080.79,Cash,Swansea,Uk
4145,4146,16/08/2018,DD,O2,19.0,,17140.79,Other Shopping,Swansea,Uk
4146,4147,15/08/2018,BP,SAVE THE CHANGE,0.11,,17159.79,Savings,Swansea,Uk
4147,4148,14/08/2018,DEB,AMZN Mktp UK,6.89,,17159.9,Amazon,Swansea,Uk
4148,4149,14/08/2018,BP,SAVE THE CHANGE,0.6,,17166.79,Savings,Swansea,Uk
4149,4150,13/08/2018,DEB,AMZN MKTP UK AMAZO,5.4,,17167.39,Amazon,Swansea,Uk
4150,4151,08/08/2018,DD,LV LIFE,37.12,,17172.79,Insurance,Swansea,Uk
4151,4152,06/08/2018,DEB,NON-STG CASH FEE,1.5,,17209.91,Others,Swansea,Uk
4152,4153,06/08/2018,DEB,NON-STG TRANS FEE,2.66,,17211.41,Others,Swansea,Uk
4153,4154,06/08/2018,DEB,ST PAUL'S BAY,89.2,,17214.07,Travel,Malia,Greece
4154,4155,06/08/2018,DD,ASSURANT INTER LTD,21.37,,17303.27,Insurance,Swansea,Uk
4155,4156,02/08/2018,DEP,CLUB LLOYDS WAIVED,,3.0,17324.64,Interest,Swansea,Uk
4156,4157,02/08/2018,PAY,CLUB LLOYDS FEE,3.0,,17321.64,Bills,Swansea,Uk
4157,4158,01/08/2018,,INTEREST (GROSS),,6.12,17324.64,Supplementary Income,Swansea,Uk
4158,4159,01/08/2018,DD,PRINCIPALITY BS,957.26,,17318.52,Mortgage,Swansea,Uk
4159,4160,01/08/2018,DD,CC SWANSEA C.TAX,184.0,,18275.78,Bills,Swansea,Uk
4160,4161,01/08/2018,DD,GOOD ENERGY LTD,97.0,,18459.78,Bills,Swansea,Uk
4161,4162,01/08/2018,DD,AVIVA LIFE,46.46,,18556.78,Insurance,Swansea,Uk
4162,4163,01/08/2018,DD,DWR CYMRU W WATER,23.5,,18603.24,Bills,Swansea,Uk
4163,4164,01/08/2018,DD,ZURICH,19.36,,18626.74,Insurance,Swansea,Uk
4164,4165,01/08/2018,SO,ESAVINGS ACCOUNT,300.0,,18646.1,Savings,Swansea,Uk
4165,4166,31/07/2018,DD,UCU B ACCOUNT,23.11,,18946.1,Others,Swansea,Uk
4166,4167,31/07/2018,BP,SAVE THE CHANGE,2.14,,18969.21,Savings,Swansea,Uk
4167,4168,31/07/2018,BGC,SWANSEA UNI - PAY,,3200.58,18971.35,Paycheck,Swansea,Uk
4168,4169,30/07/2018,DEB,NON-STG PURCH FEE,0.5,,15770.77,Others,Swansea,Uk
4169,4170,30/07/2018,DEB,NON-STG TRANS FEE,5.38,,15771.27,Others,Swansea,Uk
4170,4171,30/07/2018,DEB,Hotel on Booking.c,180.25,,15776.65,Hotels,,
4171,4172,30/07/2018,DEB,Amazon UK Retail,9.87,,15956.9,Amazon,Swansea,Uk
4172,4173,30/07/2018,DEB,JS ONLINE GROCERY,100.55,,15966.77,Groceries,Swansea,Uk
4173,4174,30/07/2018,DEB,Brontosaurus Vegan,36.2,,16067.32,Dine Out,Swansea,Uk
4174,4175,30/07/2018,DEB,Amazon UK Marketpl,15.99,,16103.52,Amazon,Swansea,Uk
4175,4176,30/07/2018,BP,SAVE THE CHANGE,0.87,,16119.51,Savings,Swansea,Uk
4176,4177,30/07/2018,CPT,LNK 37 THE QUADANT,182.13,,16120.38,Cash,Oakham,Uk
4177,4178,27/07/2018,DEB,AMAZON SVCS EU-UK,11.13,,16302.51,Amazon,Swansea,Uk
4178,4179,27/07/2018,CPT,LNK UNI - UNIVERSI,40.0,,16313.64,Cash,Swansea,Uk
4179,4180,27/07/2018,BP,SAVE THE CHANGE,0.06,,16353.64,Savings,Swansea,Uk
4180,4181,27/07/2018,BGC,SWANSEA UNIVERSITY,,136.28,16353.7,Supplementary Income,Swansea,Uk
4181,4182,26/07/2018,DEB,Amazon UK Marketpl,42.94,,16217.42,Amazon,Swansea,Uk
4182,4183,26/07/2018,BP,SAVE THE CHANGE,0.75,,16260.36,Savings,Swansea,Uk
4183,4184,25/07/2018,DEB,Amazon UK Marketpl,4.25,,16261.11,Amazon,Swansea,Uk
4184,4185,25/07/2018,CPT,LNK UNI - UNIVERSI,60.0,,16265.36,Cash,Swansea,Uk
4185,4186,25/07/2018,BP,SAVE THE CHANGE,0.52,,16325.36,Savings,Swansea,Uk
4186,4187,24/07/2018,DEB,Amazon UK Marketpl,4.49,,16325.88,Amazon,Swansea,Uk
4187,4188,24/07/2018,DEB,Audible.co.uk,7.99,,16330.37,Entertainment,Swansea,Uk
4188,4189,24/07/2018,BP,SAVE THE CHANGE,0.5,,16338.36,Savings,Swansea,Uk
4189,4190,23/07/2018,DEB,ROOT,3.5,,16338.86,Entertainment,Swansea,Uk
4190,4191,23/07/2018,DD,VIRGIN MEDIA PYMTS,27.0,,16342.36,Bills,Nottingham,Uk
4191,4192,23/07/2018,CPT,LOYD 802 OXFORD ST,50.0,,16369.36,,,
4192,4193,20/07/2018,CPT,LNK UNI - UNIVERSI,60.0,,16419.36,Cash,Swansea,Uk
4193,4194,17/07/2018,BP,SAVE THE CHANGE,1.55,,16479.36,Savings,Swansea,Uk
4194,4195,16/07/2018,DEB,ARRIVA TRAINS WALE,75.1,,16480.91,Travel,,
4195,4196,16/07/2018,DEB,BIRMINGHAM INT HOT,33.0,,16556.01,Hotels,Birmingham,Uk
4196,4197,16/07/2018,DEB,Amazon UK Marketpl,5.35,,16589.01,Amazon,Swansea,Uk
4197,4198,16/07/2018,DD,O2,17.95,,16594.36,Other Shopping,Swansea,Uk
4198,4199,16/07/2018,CPT,LNK ARRIVA TRAINS,60.0,,16612.31,Cash,,
4199,4200,13/07/2018,CPT,LNK ARRIVA TRAINS,40.0,,16672.31,Cash,,
4200,4201,13/07/2018,BGC,SWANSEA UNIVERSITY,,939.33,16712.31,Supplementary Income,Swansea,Uk
4201,4202,11/07/2018,BP,SAVE THE CHANGE,0.7,,15772.98,Savings,Swansea,Uk
4202,4203,10/07/2018,DEB,ARRIVA TRAINS WALE,128.3,,15773.68,Travel,,
4203,4204,10/07/2018,DEB,THE ALBANY HOTEL,75.0,,15901.98,Hotels,,
4204,4205,09/07/2018,CPT,LNK UNI - UNIVERSI,40.0,,15976.98,Cash,Swansea,Uk
4205,4206,09/07/2018,DD,LV LIFE,37.12,,16016.98,Insurance,Swansea,Uk
4206,4207,09/07/2018,BP,SAVE THE CHANGE,0.91,,16054.1,Savings,Swansea,Uk
4207,4208,06/07/2018,DEB,AMAZON EU AMAZON.C,7.09,,16055.01,Amazon,Swansea,Uk
4208,4209,06/07/2018,BP,SAVE THE CHANGE,1.39,,16062.1,Savings,Swansea,Uk
4209,4210,05/07/2018,DEB,WATSON & PRATTS,92.53,,16063.49,Groceries,Lampeter,Uk
4210,4211,05/07/2018,DEB,Amazon UK Retail,19.08,,16156.02,Amazon,Swansea,Uk
4211,4212,04/07/2018,DEP,CLUB LLOYDS WAIVED,,3.0,16175.1,Supplementary Income,Swansea,Uk
4212,4213,04/07/2018,PAY,CLUB LLOYDS FEE,3.0,,16172.1,Bills,Swansea,Uk
4213,4214,04/07/2018,BP,SAVE THE CHANGE,0.52,,16175.1,Savings,Swansea,Uk
4214,4215,03/07/2018,DEB,Amazon UK Marketpl,12.48,,16175.62,Amazon,Swansea,Uk
4215,4216,03/07/2018,DD,ASSURANT INTER LTD,21.37,,16188.1,Insurance,Swansea,Uk
4216,4217,03/07/2018,DD,ZURICH,19.36,,16209.47,Insurance,Swansea,Uk
4217,4218,03/07/2018,BP,SAVE THE CHANGE,0.01,,16228.83,Savings,Swansea,Uk
4218,4219,02/07/2018,,INTEREST (GROSS),,8.28,16228.84,Interest,Swansea,Uk
4219,4220,02/07/2018,DEB,Amazon UK Marketpl,16.99,,16220.56,Amazon,Swansea,Uk
4220,4221,02/07/2018,DD,PRINCIPALITY BS,957.26,,16237.55,Mortgage,Swansea,Uk
4221,4222,02/07/2018,DD,CC SWANSEA C.TAX,184.0,,17194.81,Bills,Swansea,Uk
4222,4223,02/07/2018,DD,GOOD ENERGY LTD,97.0,,17378.81,Bills,Swansea,Uk
4223,4224,02/07/2018,DD,AVIVA LIFE,46.46,,17475.81,Insurance,Swansea,Uk
4224,4225,02/07/2018,DD,DWR CYMRU W WATER,23.5,,17522.27,Bills,Swansea,Uk
4225,4226,02/07/2018,SO,ESAVINGS ACCOUNT,300.0,,17545.77,Savings,Swansea,Uk
4226,4227,02/07/2018,BP,SAVE THE CHANGE,1.32,,17845.77,Savings,Swansea,Uk
4227,4228,02/07/2018,DEB,NON-STG PURCH FEE,0.5,,17847.09,Others,Swansea,Uk
4228,4229,02/07/2018,DEB,NON-STG TRANS FEE,7.16,,17847.59,Others,Swansea,Uk
4229,4230,02/07/2018,DEB,Hotel on Booking.c,239.51,,17854.75,Hotels,,
4230,4231,29/06/2018,DEB,RYANAIR   224000,251.38,,18094.26,Travel,,
4231,4232,29/06/2018,DD,UCU B ACCOUNT,23.11,,18345.64,Others,Swansea,Uk
4232,4233,29/06/2018,DEB,NON-STG PURCH FEE,0.5,,18368.75,Others,Swansea,Uk
4233,4234,29/06/2018,DEB,NON-STG TRANS FEE,5.34,,18369.25,Others,Swansea,Uk
4234,4235,29/06/2018,DEB,Hotel on Booking.c,178.79,,18374.59,Hotels,,
4235,4236,29/06/2018,BGC,SWANSEA UNI - PAY,,3200.58,18553.38,Paycheck,Swansea,Uk
4236,4237,26/06/2018,BP,SAVE THE CHANGE,1.11,,15352.8,Savings,Swansea,Uk
4237,4238,25/06/2018,DEB,MARKS&SPENCER PLC,2.5,,15353.91,Clothes,,
4238,4239,25/06/2018,DEB,Audible.co.uk,7.99,,15356.41,Entertainment,Swansea,Uk
4239,4240,25/06/2018,DEB,ARRIVA TRAINS WALE,96.4,,15364.4,Travel,,
4240,4241,25/06/2018,CPT,LNK UNI - UNIVERSI,50.0,,15460.8,Cash,Swansea,Uk
4241,4242,25/06/2018,CPT,LNK M&S SWANSEA,60.0,,15510.8,Cash,Swansea,Uk
4242,4243,22/06/2018,BP,SAVE THE CHANGE,0.03,,15570.8,Savings,Swansea,Uk
4243,4244,22/06/2018,BGC,SWANSEA UNIVERSITY,,604.21,15570.83,Supplementary Income,Swansea,Uk
4244,4245,21/06/2018,CPT,LNK GREATER ANGLIA,50.0,,14966.62,Cash,,
4245,4246,21/06/2018,DEB,AMAZON EU AMAZON.C,24.98,,15016.62,Amazon,Swansea,Uk
4246,4247,21/06/2018,DEB,AMAZON EU AMAZON.C,9.99,,15041.6,Amazon,Swansea,Uk
4247,4248,21/06/2018,DD,VIRGIN MEDIA PYMTS,27.0,,15051.59,Bills,Nottingham,Uk
4248,4249,18/06/2018,DD,O2,18.3,,15078.59,Other Shopping,Swansea,Uk
4249,4250,15/06/2018,CPT,LNK UNI - UNIVERSI,50.0,,15096.89,Cash,Swansea,Uk
4250,4251,15/06/2018,BP,SAVE THE CHANGE,0.32,,15146.89,Savings,Swansea,Uk
4251,4252,14/06/2018,DEB,NON-STG PURCH FEE,0.5,,15147.21,Others,Swansea,Uk
4252,4253,14/06/2018,DEB,NON-STG TRANS FEE,7.34,,15147.71,Others,Swansea,Uk
4253,4254,14/06/2018,DEB,HOTEL PRAGUE CASTL,245.68,,15155.05,Hotels,Prague,Czech republic
4254,4255,12/06/2018,BP,SAVE THE CHANGE,1.91,,15400.73,Savings,Swansea,Uk
4255,4256,11/06/2018,DEB,NON-STG PURCH FEE,0.5,,15402.64,Others,Swansea,Uk
4256,4257,11/06/2018,DEB,NON-STG TRANS FEE,10.83,,15403.14,Others,Swansea,Uk
4257,4258,11/06/2018,DEB,RECEPCE,362.21,,15413.97,Others,Swansea,Uk
4258,4259,11/06/2018,DEB,FOREIGN CASH FEE,1.5,,15776.18,Travel,,
4259,4260,11/06/2018,DEB,WILSONOVA 300/8,114.02,,15777.68,Travel,Vinohrady,Prague
4260,4261,11/06/2018,DEB,NON-STG PURCH FEE,0.5,,15891.7,Others,Swansea,Uk
4261,4262,11/06/2018,DEB,NON-STG TRANS FEE,0.45,,15892.2,Others,Swansea,Uk
4262,4263,11/06/2018,DEB,BIOPOINT,15.37,,15892.65,Other Shopping,,
4263,4264,11/06/2018,DEB,NON-STG PURCH FEE,0.5,,15908.02,Others,Swansea,Uk
4264,4265,11/06/2018,DEB,NON-STG TRANS FEE,0.22,,15908.52,Others,Swansea,Uk
4265,4266,11/06/2018,DEB,CD BRNO HL.N.,7.51,,15908.74,Travel,Brno,Czech republic
4266,4267,08/06/2018,DD,LV LIFE,37.12,,15916.25,Insurance,Swansea,Uk
4267,4268,06/06/2018,BP,SAVE THE CHANGE,0.95,,15953.37,Savings,Swansea,Uk
4268,4269,05/06/2018,DEB,Acron Czech s.r.o.,95.05,,15954.32,Hotels,Prague,Czech republic
4269,4270,04/06/2018,DEP,CLUB LLOYDS WAIVED,,3.0,16049.37,Insurance,Swansea,Uk
4270,4271,04/06/2018,PAY,CLUB LLOYDS FEE,3.0,,16046.37,Bills,Swansea,Uk
4271,4272,04/06/2018,DD,ASSURANT INTER LTD,21.37,,16049.37,Supplementary Income,Swansea,Uk
4272,4273,04/06/2018,BP,SAVE THE CHANGE,0.01,,16070.74,Savings,Swansea,Uk
4273,4274,01/06/2018,,INTEREST (GROSS),,8.42,16070.75,Interest,Swansea,Uk
4274,4275,01/06/2018,DEB,AMAZON SVCS EU-UK,11.99,,16062.33,Amazon,Swansea,Uk
4275,4276,01/06/2018,DD,PRINCIPALITY BS,957.26,,16074.32,Mortgage,Swansea,Uk
4276,4277,01/06/2018,DD,CC SWANSEA C.TAX,184.0,,17031.58,Bills,Swansea,Uk
4277,4278,01/06/2018,DD,GOOD ENERGY LTD,97.0,,17215.58,Bills,Swansea,Uk
4278,4279,01/06/2018,DD,AVIVA LIFE,46.46,,17312.58,Insurance,Swansea,Uk
4279,4280,01/06/2018,DD,DWR CYMRU W WATER,23.5,,17359.04,Bills,Swansea,Uk
4280,4281,01/06/2018,DD,ZURICH,19.36,,17382.54,Insurance,Swansea,Uk
4281,4282,01/06/2018,SO,ESAVINGS ACCOUNT,300.0,,17401.9,Savings,Swansea,Uk
4282,4283,31/05/2018,DD,UCU B ACCOUNT,23.11,,17701.9,Others,Swansea,Uk
4283,4284,31/05/2018,BP,SAVE THE CHANGE,0.12,,17725.01,Savings,Swansea,Uk
4284,4285,31/05/2018,BGC,SWANSEA UNI - PAY,,3200.58,17725.13,Paycheck,Swansea,Uk
4285,4286,30/05/2018,DEB,RYANAIR   224000,208.88,,14524.55,Travel,,
4286,4287,30/05/2018,BP,SAVE THE CHANGE,1.7,,14733.43,Savings,Swansea,Uk
4287,4288,29/05/2018,DEB,Amazon UK Marketpl,59.98,,14735.13,Amazon,Swansea,Uk
4288,4289,29/05/2018,DEB,Amazon UK Marketpl,3.07,,14795.11,Amazon,Swansea,Uk
4289,4290,29/05/2018,DEB,ROOT,4.25,,14798.18,Entertainment,Swansea,Uk
4290,4291,29/05/2018,CPT,LNK 37 THE QUADANT,105.62,,14802.43,Cash,Oakham,Uk
4291,4292,29/05/2018,CPT,LNK M&S SWANSEA,50.0,,14908.05,Cash,Swansea,Uk
4292,4293,25/05/2018,CPT,LNK UNI - UNIVERSI,60.0,,14958.05,Cash,Swansea,Uk
4293,4294,25/05/2018,BP,SAVE THE CHANGE,0.01,,15018.05,Savings,Swansea,Uk
4294,4295,24/05/2018,DEB,Audible Ltd,7.99,,15018.06,Entertainment,Swansea,Uk
4295,4296,23/05/2018,DEB,THE BIKE HUB,105.0,,15026.05,Other Shopping,,
4296,4297,22/05/2018,BP,SAVE THE CHANGE,0.52,,15131.05,Savings,Swansea,Uk
4297,4298,21/05/2018,DEB,Brontosaurus Vegan,19.48,,15131.57,Dine Out,Swansea,Uk
4298,4299,21/05/2018,CPT,LNK UNI - UNIVERSI,50.0,,15151.05,Cash,Swansea,Uk
4299,4300,21/05/2018,DD,VIRGIN MEDIA PYMTS,27.0,,15201.05,Bills,Nottingham,Uk
4300,4301,18/05/2018,CPT,LNK UNI - UNIVERSI,50.0,,15228.05,Cash,Swansea,Uk
4301,4302,16/05/2018,DD,O2,26.54,,15278.05,Other Shopping,Swansea,Uk
4302,4303,16/05/2018,BP,SAVE THE CHANGE,0.05,,15304.59,Savings,Swansea,Uk
4303,4304,15/05/2018,DEB,Amazon UK Marketpl,33.95,,15304.64,Amazon,Swansea,Uk
4304,4305,14/05/2018,FPI,BAMFORD C   ADGD,,33.45,15338.59,Supplementary Income,Swansea,Uk
4305,4306,14/05/2018,CPT,LNK M&S SWANSEA,50.0,,15305.14,Cash,Swansea,Uk
4306,4307,11/05/2018,CPT,LNK UNI - UNIVERSI,50.0,,15355.14,Cash,Swansea,Uk
4307,4308,11/05/2018,DD,LV LIFE,37.12,,15405.14,Insurance,Swansea,Uk
4308,4309,11/05/2018,BP,SAVE THE CHANGE,0.53,,15442.26,Savings,Swansea,Uk
4309,4310,10/05/2018,TFR,P M GREY,2500.0,,15442.79,Services,Swansea,Uk
4310,4311,10/05/2018,DEB,AMAZON EU AMAZON.C,39.47,,17942.79,Amazon,Swansea,Uk
4311,4312,09/05/2018,BP,SAVE THE CHANGE,0.03,,17982.26,Savings,Swansea,Uk
4312,4313,08/05/2018,DEB,Amazon UK Marketpl,14.97,,17982.29,Amazon,Swansea,Uk
4313,4314,03/05/2018,DD,ASSURANT INTER LTD,21.37,,17997.26,Insurance,Swansea,Uk
4314,4315,03/05/2018,DD,PAYPAL PAYMENT,3.84,,18018.63,Others,Swansea,Uk
4315,4316,03/05/2018,BP,SAVE THE CHANGE,0.51,,18022.47,Savings,Swansea,Uk
4316,4317,02/05/2018,DEB,Amazon UK Retail,24.49,,18022.98,Amazon,Swansea,Uk
4317,4318,02/05/2018,TFR,P M GREY,2000.0,,18047.47,Services,Swansea,Uk
4318,4319,01/05/2018,FEE,SILVER ACCOUNT,9.59,,20047.47,Bills,Swansea,Uk
4319,4320,01/05/2018,,INTEREST (GROSS),,0.27,20057.06,Interest,Swansea,Uk
4320,4321,01/05/2018,DD,PRINCIPALITY BS,957.26,,20056.79,Mortgage,Swansea,Uk
4321,4322,01/05/2018,DD,CC SWANSEA C.TAX,184.0,,21014.05,Bills,Swansea,Uk
4322,4323,01/05/2018,DD,GOOD ENERGY LTD,97.0,,21198.05,Bills,Swansea,Uk
4323,4324,01/05/2018,DD,AVIVA LIFE,46.46,,21295.05,Insurance,Swansea,Uk
4324,4325,01/05/2018,DD,DWR CYMRU W WATER,23.5,,21341.51,Bills,Swansea,Uk
4325,4326,01/05/2018,DD,ZURICH,19.36,,21365.01,Insurance,Swansea,Uk
4326,4327,01/05/2018,SO,ESAVINGS ACCOUNT,300.0,,21384.37,Savings,Swansea,Uk
4327,4328,01/05/2018,BP,SAVE THE CHANGE,0.97,,21684.37,Savings,Swansea,Uk
4328,4329,30/04/2018,DEB,Amazon UK Marketpl,21.03,,21685.34,Amazon,Swansea,Uk
4329,4330,30/04/2018,DD,UCU B ACCOUNT,23.11,,21706.37,Others,Swansea,Uk
4330,4331,30/04/2018,BP,SAVE THE CHANGE,0.11,,21729.48,Savings,Swansea,Uk
4331,4332,30/04/2018,BGC,SWANSEA UNI - PAY,,3200.98,21729.59,Paycheck,Swansea,Uk
4332,4333,30/04/2018,CPT,LOYD 802 OXFORD ST,50.0,,18528.61,,,
4333,4334,27/04/2018,DEB,KLM UK  074532,260.89,,18578.61,Travel,,
4334,4335,27/04/2018,CPT,LNK UNI - UNIVERSI,60.0,,18839.5,Cash,Swansea,Uk
4335,4336,27/04/2018,BP,SAVE THE CHANGE,0.12,,18899.5,Savings,Swansea,Uk
4336,4337,26/04/2018,DEB,Amazon UK Marketpl,51.88,,18899.62,Amazon,Swansea,Uk
4337,4338,26/04/2018,DEB,EXPEDIA 7347956738,3.0,,18951.5,Travel,,
4338,4339,26/04/2018,BP,SAVE THE CHANGE,0.98,,18954.5,Savings,Swansea,Uk
4339,4340,25/04/2018,DEB,AMAZON SVCS EU-UK,9.02,,18955.48,Amazon,Swansea,Uk
4340,4341,25/04/2018,CPT,LNK UNI - UNIVERSI,50.0,,18964.5,Cash,Swansea,Uk
4341,4342,25/04/2018,BP,SAVE THE CHANGE,1.79,,19014.5,Savings,Swansea,Uk
4342,4343,24/04/2018,DEB,Audible Ltd,7.99,,19016.29,Entertainment,Swansea,Uk
4343,4344,24/04/2018,DEB,AMAZON EU AMAZON.C,5.39,,19024.28,Amazon,Swansea,Uk
4344,4345,24/04/2018,DEB,NON-STG PURCH FEE,0.5,,19029.67,Others,Swansea,Uk
4345,4346,24/04/2018,DEB,NON-STG TRANS FEE,1.05,,19030.17,Others,Swansea,Uk
4346,4347,24/04/2018,DEB,KLM FSSC BUD SCHI,35.16,,19031.22,Travel,Budapest,Hungary
4347,4348,24/04/2018,DEB,NON-STG PURCH FEE,0.5,,19066.38,Others,Swansea,Uk
4348,4349,24/04/2018,DEB,NON-STG TRANS FEE,0.28,,19066.88,Others,Swansea,Uk
4349,4350,24/04/2018,DEB,NS DELFT,9.67,,19067.16,Travel,Amsterdam,Netherlands
4350,4351,24/04/2018,BP,SAVE THE CHANGE,0.72,,19076.83,Savings,Swansea,Uk
4351,4352,23/04/2018,DEB,AMAZON SVCS EU-UK,8.79,,19077.55,Amazon,Swansea,Uk
4352,4353,23/04/2018,DEB,GOOGLE *YouTube Vi,3.49,,19086.34,,,
4353,4354,23/04/2018,DD,VIRGIN MEDIA PYMTS,27.0,,19089.83,Bills,Nottingham,Uk
4354,4355,20/04/2018,DEB,NON-STG CASH FEE,1.5,,19116.83,Others,Swansea,Uk
4355,4356,20/04/2018,DEB,NON-STG TRANS FEE,3.91,,19118.33,Others,Swansea,Uk
4356,4357,20/04/2018,DEB,ABN-AMRO,130.85,,19122.24,Travel,,
4357,4358,20/04/2018,DEB,NON-STG CASH FEE,1.5,,19253.09,Others,Swansea,Uk
4358,4359,20/04/2018,DEB,NON-STG TRANS FEE,5.21,,19254.59,Others,Swansea,Uk
4359,4360,20/04/2018,DEB,ABN-AMRO,174.47,,19259.8,Travel,,
4360,4361,20/04/2018,DEB,NON-STG CASH FEE,1.5,,19434.27,Others,Swansea,Uk
4361,4362,20/04/2018,DEB,NON-STG TRANS FEE,5.21,,19435.77,Others,Swansea,Uk
4362,4363,20/04/2018,DEB,ABN-AMRO,174.47,,19440.98,Travel,,
4363,4364,20/04/2018,DEB,NON-STG CASH FEE,1.5,,19615.45,Others,Swansea,Uk
4364,4365,20/04/2018,DEB,NON-STG TRANS FEE,1.3,,19616.95,Others,Swansea,Uk
4365,4366,20/04/2018,DEB,ABN-AMRO,43.62,,19618.25,Travel,,
4366,4367,19/04/2018,BP,SAVE THE CHANGE,0.31,,19661.87,Savings,Swansea,Uk
4367,4368,18/04/2018,DEB,NON-STG PURCH FEE,0.5,,19662.18,Others,Swansea,Uk
4368,4369,18/04/2018,DEB,NON-STG TRANS FEE,0.61,,19662.68,Others,Swansea,Uk
4369,4370,18/04/2018,DEB,PLUS 488,20.69,,19663.29,Others,Swansea,Uk
4370,4371,17/04/2018,BP,SAVE THE CHANGE,1.02,,19683.98,Savings,Swansea,Uk
4371,4372,16/04/2018,DEB,NON-STG PURCH FEE,0.5,,19685.0,Others,Swansea,Uk
4372,4373,16/04/2018,DEB,NON-STG TRANS FEE,0.28,,19685.5,Others,Swansea,Uk
4373,4374,16/04/2018,DEB,NS SCHIPHOL,9.53,,19685.78,Travel,Amsterdam,Netherlands
4374,4375,16/04/2018,DEB,AMAZON EU AMAZON.C,22.45,,19695.31,Amazon,Swansea,Uk
4375,4376,16/04/2018,DD,O2,23.18,,19717.76,Other Shopping,Swansea,Uk
4376,4377,16/04/2018,CPT,LNK ARRIVA TRAINS,40.0,,19740.94,Cash,,
4377,4378,16/04/2018,FPO,DEZREZ LEGAL LTD,25.8,,19780.94,Mortgage,Nottingham,Uk
4378,4379,13/04/2018,CPT,LNK UNI - UNIVERSI,100.0,,19806.74,Cash,Swansea,Uk
4379,4380,12/04/2018,BP,SAVE THE CHANGE,1.1,,19906.74,Savings,Swansea,Uk
4380,4381,11/04/2018,DEB,AMAZON SVCS EU-UK,1.74,,19907.84,Amazon,Swansea,Uk
4381,4382,11/04/2018,DEB,AMAZON SVCS EU-UK,18.16,,19909.58,Amazon,Swansea,Uk
4382,4383,10/04/2018,CPT,LNK UNI - UNIVERSI,50.0,,19927.74,Cash,Swansea,Uk
4383,4384,10/04/2018,BP,SAVE THE CHANGE,2.34,,19977.74,Savings,Swansea,Uk
4384,4385,09/04/2018,DEB,B & Q 1213,32.67,,19980.08,Home Improvement,Swansea,Uk
4385,4386,09/04/2018,DEB,AMAZON SVCS EU-UK,31.58,,20012.75,Amazon,Swansea,Uk
4386,4387,09/04/2018,DEB,AMAZON SVCS EU-UK,21.03,,20044.33,Amazon,Swansea,Uk
4387,4388,09/04/2018,DEB,Amazon UK Marketpl,16.55,,20065.36,Amazon,Swansea,Uk
4388,4389,09/04/2018,DEB,AMAZON EU AMAZON.C,13.85,,20081.91,Amazon,Swansea,Uk
4389,4390,09/04/2018,DEB,T K MAXX,12.98,,20095.76,Other Shopping,,
4390,4391,09/04/2018,DD,LV LIFE,37.12,,20108.74,Insurance,Swansea,Uk
4391,4392,09/04/2018,BP,SAVE THE CHANGE,0.1,,20145.86,Savings,Swansea,Uk
4392,4393,06/04/2018,DEB,AMAZON SVCS EU-UK,15.9,,20145.96,Amazon,Swansea,Uk
4393,4394,05/04/2018,DD,ZURICH,19.36,,20161.86,Insurance,Swansea,Uk
4394,4395,05/04/2018,BP,SAVE THE CHANGE,0.01,,20181.22,Savings,Swansea,Uk
4395,4396,04/04/2018,DEB,AMAZON SVCS EU-UK,78.99,,20181.23,Amazon,Swansea,Uk
4396,4397,04/04/2018,BP,SAVE THE CHANGE,0.94,,20260.22,Savings,Swansea,Uk
4397,4398,03/04/2018,FEE,ACCOUNT FEE,9.95,,20261.16,Bills,Swansea,Uk
4398,4399,03/04/2018,DEB,AMAZON EU AMAZON.C,69.99,,20271.11,Amazon,Swansea,Uk
4399,4400,03/04/2018,DEB,AMAZON SVCS EU-UK,5.48,,20341.1,Amazon,Swansea,Uk
4400,4401,03/04/2018,DEB,AMAZON SVCS EU-UK,3.59,,20346.58,Amazon,Swansea,Uk
4401,4402,03/04/2018,DD,PRINCIPALITY BS,957.26,,20350.17,Mortgage,Swansea,Uk
4402,4403,03/04/2018,DD,CC SWANSEA C.TAX,179.97,,21307.43,Bills,Swansea,Uk
4403,4404,03/04/2018,DD,GOOD ENERGY LTD,97.0,,21487.4,Bills,Swansea,Uk
4404,4405,03/04/2018,DD,AVIVA LIFE,46.46,,21584.4,Insurance,Swansea,Uk
4405,4406,03/04/2018,DD,ASSURANT INTER LTD,21.37,,21630.86,Insurance,Swansea,Uk
4406,4407,03/04/2018,SO,ESAVINGS ACCOUNT,300.0,,21652.23,Savings,Swansea,Uk
4407,4408,03/04/2018,BGC,SWANSEA UNIVERSITY,,175.7,21952.23,Supplementary Income,Swansea,Uk
4408,4409,03/04/2018,FPI,PAYPAL CODE 3241,,0.01,21776.53,Supplementary Income,Swansea,Uk
4409,4410,03/04/2018,CPT,LNK M&S SWANSEA,50.0,,21776.52,Cash,Swansea,Uk
4410,4411,29/03/2018,DD,UCU B ACCOUNT,23.11,,21826.52,Others,Swansea,Uk
4411,4412,29/03/2018,BGC,SWANSEA UNI - PAY,,3180.97,21849.63,Paycheck,Swansea,Uk
4412,4413,27/03/2018,CPT,LNK UNI - UNIVERSI,50.0,,18668.66,Cash,Swansea,Uk
4413,4414,27/03/2018,BP,SAVE THE CHANGE,0.08,,18718.66,Savings,Swansea,Uk
4414,4415,26/03/2018,DEB,AMAZON SVCS EU-UK,45.99,,18718.74,Amazon,Swansea,Uk
4415,4416,26/03/2018,DEB,AMAZON SVCS EU-UK,6.99,,18764.73,Amazon,Swansea,Uk
4416,4417,26/03/2018,DEB,AMAZON SVCS EU-UK,6.95,,18771.72,Amazon,Swansea,Uk
4417,4418,26/03/2018,DEB,Audible Ltd,7.99,,18778.67,Entertainment,Swansea,Uk
4418,4419,26/03/2018,BP,SAVE THE CHANGE,1.72,,18786.66,Savings,Swansea,Uk
4419,4420,26/03/2018,CPT,LNK M&S SWANSEA,50.0,,18788.38,Cash,Swansea,Uk
4420,4421,23/03/2018,DEB,AMAZON SVCS EU-UK,21.03,,18838.38,Amazon,Swansea,Uk
4421,4422,23/03/2018,DEB,AMAZON SVCS EU-UK,8.25,,18859.41,Amazon,Swansea,Uk
4422,4423,23/03/2018,CPT,LNK UNI - UNIVERSI,50.0,,18867.66,Cash,Swansea,Uk
4423,4424,21/03/2018,DD,VIRGIN MEDIA PYMTS,27.0,,18917.66,Bills,Nottingham,Uk
4424,4425,20/03/2018,BP,SAVE THE CHANGE,1.27,,18944.66,Savings,Swansea,Uk
4425,4426,19/03/2018,DEB,AMAZON SVCS EU-UK,14.99,,18945.93,Amazon,Swansea,Uk
4426,4427,19/03/2018,DEB,Amazon UK Marketpl,3.65,,18960.92,Amazon,Swansea,Uk
4427,4428,19/03/2018,DEB,KLM UK  074532,224.09,,18964.57,Travel,,
4428,4429,19/03/2018,BP,SAVE THE CHANGE,1.78,,19188.66,Savings,Swansea,Uk
4429,4430,19/03/2018,CPT,LOYD 802 OXFORD ST,50.0,,19190.44,,,
4430,4431,19/03/2018,CHQ,LOYD 802 OXFORD ST,,79.05,19240.44,Supplementary Income,Swansea,Uk
4431,4432,16/03/2018,DEB,Amazon *Mktplce EU,10.12,,19161.39,Amazon,Swansea,Uk
4432,4433,16/03/2018,DEB,EXPEDIA 7337347949,2.1,,19171.51,Travel,,
4433,4434,16/03/2018,CPT,LNK UNI - UNIVERSI,60.0,,19173.61,Cash,Swansea,Uk
4434,4435,16/03/2018,DD,O2,17.26,,19233.61,Other Shopping,Swansea,Uk
4435,4436,15/03/2018,BP,SAVE THE CHANGE,0.32,,19250.87,Savings,Swansea,Uk
4436,4437,14/03/2018,DEB,AMAZON EU AMAZON.C,17.68,,19251.19,Amazon,Swansea,Uk
4437,4438,13/03/2018,BP,SAVE THE CHANGE,0.65,,19268.87,Savings,Swansea,Uk
4438,4439,12/03/2018,DEB,GOOGLE *YouTube Vi,3.49,,19269.52,,,
4439,4440,12/03/2018,DEB,Amazon UK Marketpl,42.95,,19273.01,Amazon,Swansea,Uk
4440,4441,12/03/2018,DEB,AMAZON MKTPLACE PM,17.91,,19315.96,Amazon,Swansea,Uk
4441,4442,09/03/2018,DEB,Amazon Prime,79.0,,19333.87,Amazon,Swansea,Uk
4442,4443,09/03/2018,DD,LV LIFE,37.12,,19412.87,Insurance,Swansea,Uk
4443,4444,07/03/2018,BP,SAVE THE CHANGE,0.97,,19449.99,Savings,Swansea,Uk
4444,4445,06/03/2018,DEB,AMAZON SVCS EU-UK,21.03,,19450.96,Amazon,Swansea,Uk
4445,4446,06/03/2018,DD,ASSURANT INTER LTD,21.37,,19471.99,Insurance,Swansea,Uk
4446,4447,06/03/2018,BP,SAVE THE CHANGE,0.46,,19493.36,Savings,Swansea,Uk
4447,4448,05/03/2018,DEB,Amazon UK Marketpl,94.54,,19493.82,Amazon,Swansea,Uk
4448,4449,05/03/2018,DEB,Amazon UK Marketpl,32.0,,19588.36,Amazon,Swansea,Uk
4449,4450,05/03/2018,BP,SAVE THE CHANGE,0.25,,19620.36,Savings,Swansea,Uk
4450,4451,02/03/2018,DEB,BLS*WWWPLEDGEMUSIC,14.75,,19620.61,Entertainment,Swansea,Uk
4451,4452,02/03/2018,BP,SAVE THE CHANGE,0.85,,19635.36,Savings,Swansea,Uk
4452,4453,01/03/2018,FEE,ACCOUNT FEE,9.95,,19636.21,Bills,Swansea,Uk
4453,4454,01/03/2018,DEB,AMAZON SVCS EU-UK,46.0,,19646.16,Amazon,Swansea,Uk
4454,4455,01/03/2018,DEB,AMAZON SVCS EU-UK,16.76,,19692.16,Amazon,Swansea,Uk
4455,4456,01/03/2018,DEB,AMAZON MKTPLACE PM,13.39,,19708.92,Amazon,Swansea,Uk
4456,4457,01/03/2018,DD,PRINCIPALITY BS,957.26,,19722.31,Mortgage,Swansea,Uk
4457,4458,01/03/2018,DD,CC SWANSEA C.TAX,580.0,,20679.57,Bills,Swansea,Uk
4458,4459,01/03/2018,DD,GOOD ENERGY LTD,85.0,,21259.57,Bills,Swansea,Uk
4459,4460,01/03/2018,DD,AVIVA LIFE,46.46,,21344.57,Insurance,Swansea,Uk
4460,4461,01/03/2018,DD,DWR CYMRU W WATER,33.5,,21391.03,Bills,Swansea,Uk
4461,4462,01/03/2018,DD,ZURICH,19.36,,21424.53,Insurance,Swansea,Uk
4462,4463,01/03/2018,SO,ESAVINGS ACCOUNT,300.0,,21443.89,Savings,Swansea,Uk
4463,4464,28/02/2018,DD,UCU B ACCOUNT,23.11,,21743.89,Others,Swansea,Uk
4464,4465,28/02/2018,BP,SAVE THE CHANGE,0.55,,21767.0,Savings,Swansea,Uk
4465,4466,28/02/2018,BGC,SWANSEA UNI - PAY,,3180.97,21767.55,Paycheck,Swansea,Uk
4466,4467,28/02/2018,BGC,MIDDLESEX UNIV,,357.99,18586.58,Supplementary Income,Swansea,Uk
4467,4468,27/02/2018,DEB,Amazon UK Marketpl,12.45,,18228.59,Amazon,Swansea,Uk
4468,4469,27/02/2018,BP,SAVE THE CHANGE,0.53,,18241.04,Savings,Swansea,Uk
4469,4470,26/02/2018,DEB,AMAZON SVCS EU-UK,11.49,,18241.57,Amazon,Swansea,Uk
4470,4471,26/02/2018,DEB,Amazon UK Marketpl,9.99,,18253.06,Amazon,Swansea,Uk
4471,4472,26/02/2018,DEB,Audible Ltd,7.99,,18263.05,Entertainment,Swansea,Uk
4472,4473,26/02/2018,DEB,AMAZON EU AMAZON.C,,18.6,18271.04,Supplementary Income,Swansea,Uk
4473,4474,23/02/2018,CPT,LNK UNI - UNIVERSI,20.0,,18252.44,Cash,Swansea,Uk
4474,4475,23/02/2018,BGC,SWANSEA UNIVERSITY,,724.39,18272.44,Supplementary Income,Swansea,Uk
4475,4476,22/02/2018,CPT,LNK UNI - UNIVERSI,50.0,,17548.05,Cash,Swansea,Uk
4476,4477,22/02/2018,BP,SAVE THE CHANGE,0.1,,17598.05,Savings,Swansea,Uk
4477,4478,21/02/2018,DEB,AMAZON SVCS EU-UK,15.9,,17598.15,Amazon,Swansea,Uk
4478,4479,21/02/2018,DD,VIRGIN MEDIA PYMTS,27.0,,17614.05,Bills,Nottingham,Uk
4479,4480,20/02/2018,BP,SAVE THE CHANGE,1.94,,17641.05,Savings,Swansea,Uk
4480,4481,19/02/2018,DEB,Amazon UK Retail,19.38,,17642.99,Amazon,Swansea,Uk
4481,4482,19/02/2018,DEB,AMAZON EU AMAZON.C,18.6,,17662.37,Amazon,Swansea,Uk
4482,4483,19/02/2018,DEB,Amazon UK Marketpl,2.08,,17680.97,Amazon,Swansea,Uk
4483,4484,19/02/2018,CPT,LNK UNI - UNIVERSI,40.0,,17683.05,Cash,Swansea,Uk
4484,4485,16/02/2018,CPT,LNK UNI - UNIVERSI,40.0,,17723.05,Cash,Swansea,Uk
4485,4486,16/02/2018,DD,O2,17.26,,17763.05,Other Shopping,Swansea,Uk
4486,4487,15/02/2018,BP,SAVE THE CHANGE,0.55,,17780.31,Savings,Swansea,Uk
4487,4488,14/02/2018,DEB,Amazon UK Marketpl,17.45,,17780.86,Amazon,Swansea,Uk
4488,4489,14/02/2018,DEB,Amazon UK Retail,6.0,,17798.31,Amazon,Swansea,Uk
4489,4490,14/02/2018,CPT,LNK UNI - UNIVERSI,50.0,,17804.31,Cash,Swansea,Uk
4490,4491,14/02/2018,BP,SAVE THE CHANGE,0.37,,17854.31,Savings,Swansea,Uk
4491,4492,13/02/2018,DEB,Amazon UK Marketpl,108.98,,17854.68,Amazon,Swansea,Uk
4492,4493,13/02/2018,DEB,AMAZON SVCS EU-UK,3.65,,17963.66,Amazon,Swansea,Uk
4493,4494,12/02/2018,BP,SAVE THE CHANGE,0.21,,17967.31,Savings,Swansea,Uk
4494,4495,09/02/2018,DEB,AMAZON SVCS EU-UK,21.79,,17967.52,Amazon,Swansea,Uk
4495,4496,09/02/2018,CPT,LNK UNI - UNIVERSI,40.0,,17989.31,Cash,Swansea,Uk
4496,4497,09/02/2018,DD,LV LIFE,37.12,,18029.31,Insurance,Swansea,Uk
4497,4498,07/02/2018,CPT,LNK UNI - UNIVERSI,40.0,,18066.43,Cash,Swansea,Uk
4498,4499,07/02/2018,CHQ,LOYD 802 OXFORD ST,,2.72,18106.43,Supplementary Income,Swansea,Uk
4499,4500,07/02/2018,BP,SAVE THE CHANGE,0.63,,18103.71,Savings,Swansea,Uk
4500,4501,06/02/2018,DEB,AMAZON SVCS EU-UK,16.89,,18104.34,Amazon,Swansea,Uk
4501,4502,06/02/2018,DEB,AMAZON SVCS EU-UK,14.48,,18121.23,Amazon,Swansea,Uk
4502,4503,06/02/2018,DD,ASSURANT INTER LTD,21.37,,18135.71,Insurance,Swansea,Uk
4503,4504,06/02/2018,BP,SAVE THE CHANGE,0.01,,18157.08,Savings,Swansea,Uk
4504,4505,05/02/2018,DEB,AMAZON SVCS EU-UK,39.99,,18157.09,Amazon,Swansea,Uk
4505,4506,05/02/2018,DEB,BIRMINGHAM INT HOT,37.0,,18197.08,Hotels,Birmingham,Uk
4506,4507,05/02/2018,CPT,LNK UNI - UNIVERSI,50.0,,18234.08,Cash,Swansea,Uk
4507,4508,05/02/2018,BP,SAVE THE CHANGE,0.6,,18284.08,Savings,Swansea,Uk
4508,4509,02/02/2018,DEB,AMAZON SVCS EU-UK,17.4,,18284.68,Amazon,Swansea,Uk
4509,4510,02/02/2018,BP,SAVE THE CHANGE,0.8,,18302.08,Savings,Swansea,Uk
4510,4511,01/02/2018,FEE,ACCOUNT FEE,9.95,,18302.88,Bills,Swansea,Uk
4511,4512,01/02/2018,DEB,DELIVEROOCOUK,23.2,,18312.83,Dine Out,,
4512,4513,01/02/2018,DD,PRINCIPALITY BS,957.26,,18336.03,Mortgage,Swansea,Uk
4513,4514,01/02/2018,DD,CC SWANSEA C.TAX,580.73,,19293.29,Bills,Swansea,Uk
4514,4515,01/02/2018,DD,GOOD ENERGY LTD,85.0,,19874.02,Bills,Swansea,Uk
4515,4516,01/02/2018,DD,AVIVA LIFE,46.46,,19959.02,Insurance,Swansea,Uk
4516,4517,01/02/2018,DD,DWR CYMRU W WATER,33.5,,20005.48,Bills,Swansea,Uk
4517,4518,01/02/2018,DD,ZURICH,19.36,,20038.98,Insurance,Swansea,Uk
4518,4519,01/02/2018,SO,ESAVINGS ACCOUNT,300.0,,20058.34,Savings,Swansea,Uk
4519,4520,01/02/2018,BP,SAVE THE CHANGE,0.01,,20358.34,Savings,Swansea,Uk
4520,4521,31/01/2018,DEB,AMAZON SVCS EU-UK,19.99,,20358.35,Amazon,Swansea,Uk
4521,4522,31/01/2018,DD,UCU B ACCOUNT,23.11,,20378.34,Others,Swansea,Uk
4522,4523,31/01/2018,BP,SAVE THE CHANGE,1.1,,20401.45,Savings,Swansea,Uk
4523,4524,31/01/2018,BGC,SWANSEA UNI - PAY,,3180.98,20402.55,Paycheck,Swansea,Uk
4524,4525,30/01/2018,DEB,GWR WEBSALES,65.4,,17221.57,Travel,,
4525,4526,30/01/2018,DEB,GWR WEBSALES,32.0,,17286.97,Travel,,
4526,4527,30/01/2018,DEB,GWR WEBSALES,12.5,,17318.97,Travel,,
4527,4528,30/01/2018,CPT,LNK UNI - UNIVERSI,100.0,,17331.47,Cash,Swansea,Uk
4528,4529,29/01/2018,DEB,AMZ*Amazon.co.uk,,0.94,17431.47,Supplementary Income,Swansea,Uk
4529,4530,29/01/2018,BP,SAVE THE CHANGE,1.05,,17430.53,Savings,Swansea,Uk
4530,4531,26/01/2018,DEB,Amazon UK Retail,13.6,,17431.58,Amazon,Swansea,Uk
4531,4532,26/01/2018,DEB,Amazon UK Marketpl,5.49,,17445.18,Amazon,Swansea,Uk
4532,4533,26/01/2018,DEB,Amazon UK Marketpl,2.86,,17450.67,Amazon,Swansea,Uk
4533,4534,24/01/2018,BP,SAVE THE CHANGE,1.28,,17453.53,Savings,Swansea,Uk
4534,4535,23/01/2018,DEB,JS ONLINE GROCERY,196.22,,17454.81,Groceries,Swansea,Uk
4535,4536,23/01/2018,DEB,IKEA ONLINE,124.0,,17651.03,Other Shopping,,
4536,4537,23/01/2018,DEB,ETSY.COM - AURAGRA,20.5,,17775.03,Other Shopping,,
4537,4538,23/01/2018,DEB,JS ONLINE GROCERY,,1.3,17795.53,Supplementary Income,Swansea,Uk
4538,4539,23/01/2018,BP,SAVE THE CHANGE,0.86,,17794.23,Savings,Swansea,Uk
4539,4540,22/01/2018,DEB,Amazon *Mktplce EU,9.14,,17795.09,Amazon,Swansea,Uk
4540,4541,22/01/2018,CPT,LNK UNI - UNIVERSI,50.0,,17804.23,Cash,Swansea,Uk
4541,4542,22/01/2018,DD,VIRGIN MEDIA PYMTS,27.0,,17854.23,Bills,Nottingham,Uk
4542,4543,19/01/2018,CPT,LNK UNI - UNIVERSI,50.0,,17881.23,Cash,Swansea,Uk
4543,4544,17/01/2018,DEB,BIRMINGHAM INT HOT,,28.0,17931.23,Supplementary Income,Swansea,Uk
4544,4545,17/01/2018,CPT,LNK UNI - UNIVERSI,40.0,,17903.23,Cash,Swansea,Uk
4545,4546,17/01/2018,BP,SAVE THE CHANGE,2.9,,17943.23,Savings,Swansea,Uk
4546,4547,16/01/2018,DEB,GWR WEBSALES,148.2,,17946.13,Travel,,
4547,4548,16/01/2018,DEB,QUEENS HOTEL,87.3,,18094.33,Hotels,Leeds,Uk
4548,4549,16/01/2018,DEB,ARRIVA TRAINS WALE,62.4,,18181.63,Travel,Birmingham,Uk
4549,4550,16/01/2018,DEB,WEST COAST TRAINS,62.2,,18244.03,Travel,,
4550,4551,16/01/2018,DEB,BIRMINGHAM INT HOT,28.0,,18306.23,Hotels,Birmingham,Uk
4551,4552,16/01/2018,DD,O2,17.26,,18334.23,Other Shopping,Swansea,Uk
4552,4553,16/01/2018,BP,SAVE THE CHANGE,0.97,,18351.49,Savings,Swansea,Uk
4553,4554,15/01/2018,DEB,AMAZON EU AMAZON.C,6.0,,18352.46,Amazon,Swansea,Uk
4554,4555,15/01/2018,DEB,AMAZON EU AMAZON.C,6.0,,18358.46,Amazon,Swansea,Uk
4555,4556,15/01/2018,DEB,Amazon UK Marketpl,5.82,,18364.46,Amazon,Swansea,Uk
4556,4557,15/01/2018,DEB,AMAZON EU AMAZON.C,5.21,,18370.28,Amazon,Swansea,Uk
4557,4558,15/01/2018,BP,SAVE THE CHANGE,0.2,,18375.49,Savings,Swansea,Uk
4558,4559,12/01/2018,DEB,ARRIVA TRAINS WALE,23.8,,18375.69,Travel,Birmingham,Uk
4559,4560,12/01/2018,CPT,LNK UNI - UNIVERSI,50.0,,18399.49,Cash,Swansea,Uk
4560,4561,12/01/2018,BP,SAVE THE CHANGE,0.8,,18449.49,Savings,Swansea,Uk
4561,4562,11/01/2018,DEB,DELIVEROOCOUK,22.2,,18450.29,Dine Out,Swansea,Uk
4562,4563,11/01/2018,CPT,LNK ARRIVA TRAINS,40.0,,18472.49,Cash,Birmingham,Uk
4563,4564,11/01/2018,BP,SAVE THE CHANGE,1.62,,18512.49,Savings,Swansea,Uk
4564,4565,10/01/2018,DEB,Amazon UK Marketpl,14.99,,18514.11,Amazon,Swansea,Uk
4565,4566,10/01/2018,DEB,Amazon UK Marketpl,3.09,,18529.1,Amazon,Swansea,Uk
4566,4567,10/01/2018,DEB,Amazon UK Marketpl,1.3,,18532.19,Amazon,Swansea,Uk
4567,4568,10/01/2018,DEB,BRITANNIA,28.0,,18533.49,Entertainment,Swansea,Uk
4568,4569,09/01/2018,CPT,LNK UNI - UNIVERSI,40.0,,18561.49,Cash,Swansea,Uk
4569,4570,09/01/2018,BP,SAVE THE CHANGE,0.03,,18601.49,Savings,Swansea,Uk
4570,4571,08/01/2018,DEB,Amazon UK Marketpl,10.98,,18601.52,Amazon,Swansea,Uk
4571,4572,08/01/2018,DEB,Amazon UK Marketpl,5.99,,18612.5,Amazon,Swansea,Uk
4572,4573,08/01/2018,DD,LV LIFE,37.12,,18618.49,Insurance,Swansea,Uk
4573,4574,08/01/2018,BP,SAVE THE CHANGE,1.06,,18655.61,Savings,Swansea,Uk
4574,4575,05/01/2018,DEB,Amazon UK Marketpl,29.96,,18656.67,Amazon,Swansea,Uk
4575,4576,05/01/2018,DEB,Amazon UK Marketpl,6.94,,18686.63,Amazon,Swansea,Uk
4576,4577,05/01/2018,DEB,Amazon UK Marketpl,6.04,,18693.57,Amazon,Swansea,Uk
4577,4578,05/01/2018,CPT,LNK UNI - UNIVERSI,50.0,,18699.61,Cash,Swansea,Uk
4578,4579,04/01/2018,DD,ZURICH,19.36,,18749.61,Insurance,Swansea,Uk
4579,4580,03/01/2018,DD,ASSURANT INTER LTD,21.37,,18768.97,Insurance,Swansea,Uk
4580,4581,03/01/2018,BP,SAVE THE CHANGE,1.19,,18790.34,Savings,Swansea,Uk
4581,4582,02/01/2018,FEE,ACCOUNT FEE,9.95,,18791.53,Bills,Swansea,Uk
4582,4583,02/01/2018,DEB,Amazon UK Marketpl,5.55,,18801.48,Amazon,Swansea,Uk
4583,4584,02/01/2018,DEB,Amazon UK Marketpl,6.99,,18807.03,Amazon,Swansea,Uk
4584,4585,02/01/2018,DEB,NON-STG PURCH FEE,0.5,,18814.02,Others,Swansea,Uk
4585,4586,02/01/2018,DEB,NON-STG TRANS FEE,2.16,,18814.52,Others,Swansea,Uk
4586,4587,02/01/2018,DEB,ATHLEAN-X,72.27,,18816.68,Entertainment,Swansea,Uk
4587,4588,02/01/2018,DD,PRINCIPALITY BS,957.26,,18888.95,Mortgage,Swansea,Uk
4588,4589,02/01/2018,DD,GOOD ENERGY LTD,85.0,,19846.21,Bills,Swansea,Uk
4589,4590,02/01/2018,DD,AVIVA LIFE,46.46,,19931.21,Insurance,Swansea,Uk
4590,4591,02/01/2018,DD,DWR CYMRU W WATER,33.5,,19977.67,Bills,Swansea,Uk
4591,4592,02/01/2018,SO,ESAVINGS ACCOUNT,300.0,,20011.17,Savings,Swansea,Uk
4592,4593,02/01/2018,BP,SAVE THE CHANGE,0.98,,20311.17,Savings,Swansea,Uk
4593,4594,02/01/2018,DEB,NON-STG PURCH FEE,0.5,,20312.15,Others,Swansea,Uk
4594,4595,02/01/2018,DEB,NON-STG TRANS FEE,0.95,,20312.65,Others,Swansea,Uk
4595,4596,02/01/2018,DEB,REST JARDIM DAS CE,32.02,,20313.6,Dine Out,Lisbon,Portugal
4596,4597,29/12/2017,DD,UCU B ACCOUNT,23.11,,20345.62,Others,Swansea,Uk
4597,4598,29/12/2017,BP,SAVE THE CHANGE,0.06,,20368.73,Savings,Swansea,Uk
4598,4599,28/12/2017,DEB,FOREIGN CASH FEE,1.5,,20368.79,Travel,Setubal,Portugal
4599,4600,28/12/2017,DEB,Alegro Setubal-P1,96.75,,20370.29,Other Shopping,Setubal,Portugal
4600,4601,28/12/2017,DEB,AMAZON MKTPLACE PM,17.94,,20467.04,Amazon,Swansea,Uk
4601,4602,27/12/2017,BP,SAVE THE CHANGE,0.47,,20484.98,Savings,Swansea,Uk
4602,4603,22/12/2017,DEB,NON-STG PURCH FEE,0.5,,20485.45,Others,Swansea,Uk
4603,4604,22/12/2017,DEB,NON-STG TRANS FEE,1.54,,20485.95,Others,Swansea,Uk
4604,4605,22/12/2017,DEB,JUMBO SETUBAL,51.53,,20487.49,Other Shopping,Setubal,Portugal
4605,4606,22/12/2017,BP,SAVE THE CHANGE,0.62,,20539.02,Savings,Swansea,Uk
4606,4607,21/12/2017,DEB,AMAZON MKTPLACE PM,17.94,,20539.64,Amazon,Swansea,Uk
4607,4608,21/12/2017,DEB,GODADDY COM EUROPE,31.44,,20557.58,Others,Swansea,Uk
4608,4609,21/12/2017,DD,VIRGIN MEDIA PYMTS,27.0,,20589.02,Bills,Nottingham,Uk
4609,4610,21/12/2017,BP,SAVE THE CHANGE,0.26,,20616.02,Savings,Swansea,Uk
4610,4611,20/12/2017,DEB,ARRIVA TRAINS WALE,73.8,,20616.28,Travel,Setubal,Portugal
4611,4612,20/12/2017,DEB,AMAZON MKTPLACE PM,17.94,,20690.08,Amazon,Swansea,Uk
4612,4613,20/12/2017,BP,SAVE THE CHANGE,0.62,,20708.02,Savings,Swansea,Uk
4613,4614,20/12/2017,BGC,SWANSEA UNI - PAY,,3180.97,20708.64,Paycheck,Swansea,Uk
4614,4615,19/12/2017,DEB,Amazon UK Marketpl,4.38,,17527.67,Amazon,Swansea,Uk
4615,4616,19/12/2017,BP,SAVE THE CHANGE,0.72,,17532.05,Savings,Swansea,Uk
4616,4617,18/12/2017,DEB,GWR WEBSALES,269.3,,17532.77,Travel,Setubal,Portugal
4617,4618,18/12/2017,DEB,AMAZON EU AMAZON.C,23.99,,17802.07,Amazon,Swansea,Uk
4618,4619,18/12/2017,DEB,Amazon UK Marketpl,16.99,,17826.06,Amazon,Swansea,Uk
4619,4620,18/12/2017,CPT,LNK CAMBRIDGE STAT,50.0,,17843.05,Cash,Cambridge,Uk
4620,4621,18/12/2017,DD,O2,30.69,,17893.05,Other Shopping,Swansea,Uk
4621,4622,18/12/2017,BP,SAVE THE CHANGE,1.26,,17923.74,Savings,Swansea,Uk
4622,4623,15/12/2017,DEB,Amazon UK Retail,8.0,,17925.0,Amazon,Swansea,Uk
4623,4624,15/12/2017,DEB,Amazon UK Marketpl,6.48,,17933.0,Amazon,Swansea,Uk
4624,4625,15/12/2017,DEB,Amazon UK Marketpl,4.98,,17939.48,Amazon,Swansea,Uk
4625,4626,15/12/2017,DEB,Amazon UK Marketpl,4.28,,17944.46,Amazon,Swansea,Uk
4626,4627,15/12/2017,CPT,LNK 37 THE QUADANT,96.15,,17948.74,Cash,Swansea,Uk
4627,4628,15/12/2017,BP,SAVE THE CHANGE,0.8,,18044.89,Savings,Swansea,Uk
4628,4629,14/12/2017,DEB,DELIVEROOCOUK,20.2,,18045.69,Dine Out,,
4629,4630,14/12/2017,CPT,LNK UNI - UNIVERSI,50.0,,18065.89,Cash,Swansea,Uk
4630,4631,14/12/2017,BP,SAVE THE CHANGE,0.36,,18115.89,Savings,Swansea,Uk
4631,4632,13/12/2017,DEB,Amazon UK Retail,20.64,,18116.25,Amazon,Swansea,Uk
4632,4633,12/12/2017,CPT,LNK UNI - UNIVERSI,100.0,,18136.89,Cash,Swansea,Uk
4633,4634,11/12/2017,BP,SAVE THE CHANGE,0.11,,18236.89,Savings,Swansea,Uk
4634,4635,11/12/2017,CPT,LNK UNI - UNIVERSI,50.0,,18237.0,Cash,Swansea,Uk
4635,4636,08/12/2017,DEB,Amazon UK Marketpl,12.94,,18287.0,Amazon,Swansea,Uk
4636,4637,08/12/2017,DEB,Amazon UK Marketpl,9.95,,18299.94,Amazon,Swansea,Uk
4637,4638,08/12/2017,CPT,LNK UNI - UNIVERSI,50.0,,18309.89,Cash,Swansea,Uk
4638,4639,08/12/2017,DD,LV LIFE,37.12,,18359.89,Insurance,Swansea,Uk
4639,4640,08/12/2017,BP,SAVE THE CHANGE,1.19,,18397.01,Insurance,Swansea,Uk
4640,4641,08/12/2017,BGC,SWANSEA UNIVERSITY,,192.05,18398.2,Supplementary Income,Swansea,Uk
4641,4642,07/12/2017,DEB,Amazon UK Retail,18.6,,18206.15,Amazon,Swansea,Uk
4642,4643,07/12/2017,DEB,Amazon UK Marketpl,18.21,,18224.75,Amazon,Swansea,Uk
4643,4644,05/12/2017,CPT,LNK UNI - UNIVERSI,50.0,,18242.96,Cash,Swansea,Uk
4644,4645,05/12/2017,DD,ASSURANT INTER LTD,21.37,,18292.96,Insurance,Swansea,Uk
4645,4646,05/12/2017,BP,SAVE THE CHANGE,0.94,,18314.33,Savings,Swansea,Uk
4646,4647,04/12/2017,DEB,Amazon UK Marketpl,11.39,,18315.27,Amazon,Swansea,Uk
4647,4648,04/12/2017,DEB,Amazon UK Marketpl,9.67,,18326.66,Amazon,Swansea,Uk
4648,4649,04/12/2017,CPT,LNK UNI - UNIVERSI,50.0,,18336.33,Cash,Swansea,Uk
4649,4650,04/12/2017,BP,SAVE THE CHANGE,0.21,,18386.33,Savings,Swansea,Uk
4650,4651,01/12/2017,FEE,ACCOUNT FEE,9.95,,18386.54,Bills,Swansea,Uk
4651,4652,01/12/2017,DEB,FUNKY FUTON CO LTD,483.0,,18396.49,Home Improvement,Swansea,Uk
4652,4653,01/12/2017,DEB,Amazon UK Retail,11.79,,18879.49,Amazon,Swansea,Uk
4653,4654,01/12/2017,DD,PRINCIPALITY BS,957.26,,18891.28,Mortgage,Swansea,Uk
4654,4655,01/12/2017,DD,GOOD ENERGY LTD,85.0,,19848.54,Bills,Swansea,Uk
4655,4656,01/12/2017,DD,AVIVA LIFE,46.46,,19933.54,Insurance,Swansea,Uk
4656,4657,01/12/2017,DD,DWR CYMRU W WATER,33.5,,19980.0,Bills,Swansea,Uk
4657,4658,01/12/2017,DD,ZURICH,19.36,,20013.5,Insurance,Swansea,Uk
4658,4659,01/12/2017,SO,ESAVINGS ACCOUNT,300.0,,20032.86,Savings,Swansea,Uk
4659,4660,30/11/2017,DD,UCU B ACCOUNT,23.11,,20332.86,Others,Swansea,Uk
4660,4661,30/11/2017,BGC,SWANSEA UNI - PAY,,3180.97,20355.97,Paycheck,Swansea,Uk
4661,4662,30/11/2017,BGC,C C SWANSEA,,638.73,17175.0,Supplementary Income,Swansea,Uk
4662,4663,29/11/2017,BP,SAVE THE CHANGE,0.55,,16536.27,Savings,Swansea,Uk
4663,4664,28/11/2017,DEB,Amazon UK Marketpl,1.45,,16536.82,Amazon,Swansea,Uk
4664,4665,28/11/2017,BP,SAVE THE CHANGE,0.75,,16538.27,Savings,Swansea,Uk
4665,4666,27/11/2017,DEB,AMAZON UK RETAIL A,14.25,,16539.02,Amazon,Swansea,Uk
4666,4667,22/11/2017,BGC,MIDDLESEX UNIV.,,217.99,16553.27,Supplementary Income,Swansea,Uk
4667,4668,21/11/2017,CPT,LNK UNI - UNIVERSI,50.0,,16335.28,Cash,Swansea,Uk
4668,4669,21/11/2017,DD,VIRGIN MEDIA PYMTS,27.0,,16385.28,Bills,Nottingham,Uk
4669,4670,21/11/2017,BP,SAVE THE CHANGE,2.05,,16412.28,Savings,Swansea,Uk
4670,4671,20/11/2017,DEB,MOUNTAIN WAREHOUSE,34.99,,16414.33,Other Shopping,Leicester,Uk
4671,4672,20/11/2017,DEB,WAGAMAMA CARDIFF L,28.45,,16449.32,Dine Out,Cardiff,Uk
4672,4673,20/11/2017,DEB,AMAZON SVCS EU-UK,18.82,,16477.77,Amazon,Swansea,Uk
4673,4674,20/11/2017,DEB,Amazon UK Retail,16.76,,16496.59,Amazon,Swansea,Uk
4674,4675,20/11/2017,DEB,T K MAXX,12.97,,16513.35,Other Shopping,,
4675,4676,20/11/2017,DEB,ODEON/BOOKIT,24.0,,16526.32,Entertainment,,
4676,4677,20/11/2017,DEB,Amazon UK Marketpl,18.71,,16550.32,Amazon,Swansea,Uk
4677,4678,20/11/2017,DEB,AMAZON EU AMAZON.C,13.92,,16569.03,Amazon,Swansea,Uk
4678,4679,20/11/2017,DEB,Amazon UK Marketpl,5.35,,16582.95,Amazon,Swansea,Uk
4679,4680,20/11/2017,DEB,Amazon UK Marketpl,4.98,,16588.3,Amazon,Swansea,Uk
4680,4681,20/11/2017,BP,SAVE THE CHANGE,0.33,,16593.28,Savings,Swansea,Uk
4681,4682,17/11/2017,DEB,Amazon UK Marketpl,19.97,,16593.61,Amazon,Swansea,Uk
4682,4683,17/11/2017,DEB,DELIVEROOCOUK,22.7,,16613.58,Dine Out,,
4683,4684,17/11/2017,CPT,LNK UNI - UNIVERSI,50.0,,16636.28,Cash,Swansea,Uk
4684,4685,16/11/2017,DD,O2,27.45,,16686.28,Other Shopping,Swansea,Uk
4685,4686,15/11/2017,BP,SAVE THE CHANGE,0.01,,16713.73,Savings,Swansea,Uk
4686,4687,14/11/2017,DEB,Amazon UK Marketpl,7.99,,16713.74,Amazon,Swansea,Uk
4687,4688,14/11/2017,BP,SAVE THE CHANGE,0.99,,16721.73,Savings,Swansea,Uk
4688,4689,13/11/2017,DEB,w1185123616,94.01,,16722.72,Others,Swansea,Uk
4689,4690,13/11/2017,BP,SAVE THE CHANGE,0.3,,16816.73,Savings,Swansea,Uk
4690,4691,10/11/2017,DEB,DELIVEROOCOUK,21.7,,16817.03,Dine Out,,
4691,4692,10/11/2017,BP,SAVE THE CHANGE,0.38,,16838.73,Savings,Swansea,Uk
4692,4693,09/11/2017,DEB,AMAZON SVCS EU-UK,14.62,,16839.11,Amazon,Swansea,Uk
4693,4694,09/11/2017,BP,SAVE THE CHANGE,0.96,,16853.73,Savings,Swansea,Uk
4694,4695,08/11/2017,DEB,AMAZON SVCS EU-UK,29.05,,16854.69,Amazon,Swansea,Uk
4695,4696,08/11/2017,DEB,AMAZON SVCS EU-UK,16.99,,16883.74,Amazon,Swansea,Uk
4696,4697,08/11/2017,CPT,LNK UNI - UNIVERSI,50.0,,16900.73,Cash,Swansea,Uk
4697,4698,08/11/2017,DD,LV LIFE,37.12,,16950.73,Insurance,Swansea,Uk
4698,4699,08/11/2017,BP,SAVE THE CHANGE,0.31,,16987.85,Savings,Swansea,Uk
4699,4700,07/11/2017,DEB,AMAZON SVCS EU-UK,13.69,,16988.16,Amazon,Swansea,Uk
4700,4701,07/11/2017,BP,SAVE THE CHANGE,0.28,,17001.85,Savings,Swansea,Uk
4701,4702,06/11/2017,DEB,AMAZON SVCS EU-UK,21.98,,17002.13,Amazon,Swansea,Uk
4702,4703,06/11/2017,DEB,GWR LON PADD TO,26.9,,17024.11,Travel,London,Uk
4703,4704,06/11/2017,DEB,LUL TICKET MACHINE,4.9,,17051.01,Travel,London,Uk
4704,4705,06/11/2017,DEB,AMAZON SVCS EU-UK,2.95,,17055.91,Amazon,Swansea,Uk
4705,4706,06/11/2017,DEB,AMAZON SVCS EU-UK,14.99,,17058.86,Amazon,Swansea,Uk
4706,4707,06/11/2017,CPT,LNK UNI - UNIVERSI,60.0,,17073.85,Cash,Swansea,Uk
4707,4708,06/11/2017,BP,SAVE THE CHANGE,0.01,,17133.85,Savings,Swansea,Uk
4708,4709,03/11/2017,DEB,AMAZON SVCS EU-UK,6.99,,17133.86,Amazon,Swansea,Uk
4709,4710,03/11/2017,DD,ASSURANT INTER LTD,21.37,,17140.85,Insurance,Swansea,Uk
4710,4711,03/11/2017,BGC,SWANSEA UNIVERSITY,,1554.87,17162.22,Supplementary Income,Swansea,Uk
4711,4712,01/11/2017,FEE,ACCOUNT FEE,9.95,,15607.35,Bills,Swansea,Uk
4712,4713,01/11/2017,DD,PRINCIPALITY BS,957.26,,15617.3,Mortgage,Swansea,Uk
4713,4714,01/11/2017,DD,AVIVA LIFE,46.46,,16574.56,Insurance,Swansea,Uk
4714,4715,01/11/2017,DD,DWR CYMRU W WATER,33.5,,16621.02,Bills,Swansea,Uk
4715,4716,01/11/2017,DD,ZURICH,19.36,,16654.52,Insurance,Swansea,Uk
4716,4717,01/11/2017,SO,ESAVINGS ACCOUNT,300.0,,16673.88,Savings,Swansea,Uk
4717,4718,01/11/2017,BP,SAVE THE CHANGE,0.01,,16973.88,Savings,Swansea,Uk
4718,4719,31/10/2017,DEB,Amazon UK Marketpl,7.99,,16973.89,Amazon,Swansea,Uk
4719,4720,31/10/2017,DD,UCU B ACCOUNT,23.11,,16981.88,Others,Swansea,Uk
4720,4721,31/10/2017,BP,SAVE THE CHANGE,2.73,,17004.99,Savings,Swansea,Uk
4721,4722,31/10/2017,BGC,SWANSEA UNI - PAY,,3180.98,17007.72,Paycheck,Swansea,Uk
4722,4723,30/10/2017,DEB,Amazon UK Marketpl,7.1,,13826.74,Amazon,Swansea,Uk
4723,4724,30/10/2017,DEB,AMAZON.CO.UK,5.74,,13833.84,Amazon,Swansea,Uk
4724,4725,30/10/2017,DEB,JS ONLINE GROCERY,244.2,,13839.58,Groceries,Swansea,Uk
4725,4726,30/10/2017,DEB,WWW.GOODENERGY.CO.,145.23,,14083.78,Bills,Nottingham,Uk
4726,4727,30/10/2017,BP,SAVE THE CHANGE,0.95,,14229.01,Savings,Swansea,Uk
4727,4728,27/10/2017,DEB,DELIVEROOCOUK,20.05,,14229.96,Dine Out,,
4728,4729,27/10/2017,CPT,LNK UNI - UNIVERSI,60.0,,14250.01,Cash,Swansea,Uk
4729,4730,27/10/2017,BGC,SWANSEA UNIVERSITY,,1245.34,14310.01,Supplementary Income,Swansea,Uk
4730,4731,27/10/2017,BGC,MIDDLESEX UNIV,,140.0,13064.67,Supplementary Income,Swansea,Uk
4731,4732,25/10/2017,BP,SAVE THE CHANGE,0.35,,12924.67,Savings,Swansea,Uk
4732,4733,24/10/2017,DEB,AMAZON SVCS EU-UK,4.65,,12925.02,Amazon,Swansea,Uk
4733,4734,24/10/2017,CPT,LNK UNI - UNIVERSI,50.0,,12929.67,Cash,Swansea,Uk
4734,4735,24/10/2017,BP,SAVE THE CHANGE,1.35,,12979.67,Savings,Swansea,Uk
4735,4736,23/10/2017,DEB,IKEA ONLINE,75.4,,12981.02,Other Shopping,,
4736,4737,23/10/2017,DEB,AMAZON SVCS EU-UK,2.85,,13056.42,Amazon,Swansea,Uk
4737,4738,23/10/2017,DEB,AMAZON EU AMAZON.C,15.4,,13059.27,Amazon,Swansea,Uk
4738,4739,23/10/2017,DD,VIRGIN MEDIA PYMTS,49.0,,13074.67,Bills,Nottingham,Uk
4739,4740,23/10/2017,BP,SAVE THE CHANGE,1.03,,13123.67,Savings,Swansea,Uk
4740,4741,20/10/2017,DEB,Amazon UK Marketpl,15.77,,13124.7,Amazon,Swansea,Uk
4741,4742,20/10/2017,DEB,DELIVEROOCOUK,19.2,,13140.47,Dine Out,,
4742,4743,20/10/2017,CPT,LNK UNI - UNIVERSI,50.0,,13159.67,Cash,Swansea,Uk
4743,4744,20/10/2017,BP,SAVE THE CHANGE,0.08,,13209.67,Savings,Swansea,Uk
4744,4745,19/10/2017,DEB,Amazon UK Marketpl,14.93,,13209.75,Amazon,Swansea,Uk
4745,4746,19/10/2017,DEB,Amazon UK Marketpl,5.99,,13224.68,Amazon,Swansea,Uk
4746,4747,19/10/2017,BP,SAVE THE CHANGE,0.53,,13230.67,Savings,Swansea,Uk
4747,4748,18/10/2017,DEB,Amazon UK Retail,7.49,,13231.2,Amazon,Swansea,Uk
4748,4749,18/10/2017,DEB,Amazon UK Marketpl,2.98,,13238.69,Amazon,Swansea,Uk
4749,4750,18/10/2017,DD,ZURICH,19.36,,13241.67,Insurance,,
4750,4751,17/10/2017,CPT,LNK UNI - UNIVERSI,40.0,,13261.03,Cash,Swansea,Uk
4751,4752,17/10/2017,BP,SAVE THE CHANGE,0.23,,13301.03,Savings,Swansea,Uk
4752,4753,16/10/2017,DEB,Amazon UK Marketpl,7.77,,13301.26,Amazon,Swansea,Uk
4753,4754,16/10/2017,DD,O2,17.26,,13309.03,Other Shopping,Swansea,Uk
4754,4755,16/10/2017,BP,SAVE THE CHANGE,0.8,,13326.29,Savings,Swansea,Uk
4755,4756,13/10/2017,DEB,DELIVEROOCOUK,20.2,,13327.09,Dine Out,,
4756,4757,13/10/2017,CPT,LNK UNI - UNIVERSI,20.0,,13347.29,Cash,Swansea,Uk
4757,4758,13/10/2017,BP,SAVE THE CHANGE,0.05,,13367.29,Savings,Swansea,Uk
4758,4759,12/10/2017,DEB,Amazon UK Retail,31.95,,13367.34,Amazon,Swansea,Uk
4759,4760,12/10/2017,BP,SAVE THE CHANGE,1.33,,13399.29,Savings,Swansea,Uk
4760,4761,11/10/2017,DEB,Amazon UK Retail,14.99,,13400.62,Amazon,Swansea,Uk
4761,4762,11/10/2017,DEB,AMAZON.CO.UK,6.19,,13415.61,Amazon,Swansea,Uk
4762,4763,11/10/2017,DEB,AMAZON.CO.UK,4.49,,13421.8,Amazon,Swansea,Uk
4763,4764,11/10/2017,CHQ,LOYD 802 OXFORD ST,,383.47,13426.29,Supplementary Income,Swansea,Uk
4764,4765,11/10/2017,BP,SAVE THE CHANGE,0.87,,13042.82,Savings,Swansea,Uk
4765,4766,10/10/2017,DEB,Amazon UK Marketpl,4.38,,13043.69,Amazon,Swansea,Uk
4766,4767,10/10/2017,CPT,LNK UNI - UNIVERSI,50.0,,13048.07,Cash,Swansea,Uk
4767,4768,10/10/2017,DEB,NON-STG PURCH FEE,0.5,,13098.07,Others,Swansea,Uk
4768,4769,10/10/2017,DEB,NON-STG TRANS FEE,32.4,,13098.57,Others,Swansea,Uk
4769,4770,10/10/2017,DEB,HYATT REGENCY PHOE,1083.75,,13130.97,Hotels,Phoenix,Usa
4770,4771,09/10/2017,DD,LV LIFE,37.12,,14214.72,Insurance,Swansea,Uk
4771,4772,03/10/2017,FPI,MARIANA MILLS,,200.0,14251.84,Supplementary Income,Swansea,Uk
4772,4773,03/10/2017,DD,ASSURANT INTER LTD,21.37,,14051.84,Insurance,Swansea,Uk
4773,4774,02/10/2017,FEE,ACCOUNT FEE,9.95,,14073.21,Bills,Swansea,Uk
4774,4775,02/10/2017,DD,PRINCIPALITY BS,957.26,,14083.16,Mortgage,Swansea,Uk
4775,4776,02/10/2017,DD,CC SWANSEA C.TAX,174.0,,15040.42,Bills,Swansea,Uk
4776,4777,02/10/2017,DD,AVIVA LIFE,46.46,,15214.42,Insurance,Swansea,Uk
4777,4778,02/10/2017,DD,DWR CYMRU W WATER,33.5,,15260.88,Bills,Swansea,Uk
4778,4779,02/10/2017,SO,ESAVINGS ACCOUNT,300.0,,15294.38,Savings,Swansea,Uk
4779,4780,29/09/2017,CPT,LNK UNI - UNIVERSI,150.0,,15594.38,Cash,Swansea,Uk
4780,4781,29/09/2017,DD,UCU B ACCOUNT,23.11,,15744.38,Others,Swansea,Uk
4781,4782,29/09/2017,BP,SAVE THE CHANGE,2.27,,15767.49,Savings,Swansea,Uk
4782,4783,29/09/2017,BGC,SWANSEA UNI - PAY,,3180.97,15769.76,Paycheck,Swansea,Uk
4783,4784,28/09/2017,DEB,ARRIVA TRAINS WALE,95.3,,12588.79,Travel,,
4784,4785,28/09/2017,DEB,BIRMINGHAM INT HOT,91.5,,12684.09,Hotels,Birmingham,Uk
4785,4786,28/09/2017,DEB,WASABI BIRMINGHAM,28.0,,12775.59,Dine Out,Birmingham,Uk
4786,4787,28/09/2017,DEB,Amazon UK Marketpl,17.65,,12803.59,Amazon,Swansea,Uk
4787,4788,28/09/2017,DEB,AMAZON UK RETAIL A,12.99,,12821.24,Amazon,Swansea,Uk
4788,4789,28/09/2017,DEB,NON-STG PURCH FEE,0.5,,12834.23,Others,Swansea,Uk
4789,4790,28/09/2017,DEB,NON-STG TRANS FEE,1.11,,12834.73,Others,Swansea,Uk
4790,4791,28/09/2017,DEB,WPY*Klaus Mueller,37.29,,12835.84,Services,Swansea,Uk
4791,4792,27/09/2017,BP,SAVE THE CHANGE,2.1,,12873.13,Savings,Swansea,Uk
4792,4793,26/09/2017,DEB,ARRIVA TRAINS WALE,8.4,,12875.23,Travel,,
4793,4794,26/09/2017,DEB,Amazon UK Marketpl,6.01,,12883.63,Amazon,Swansea,Uk
4794,4795,26/09/2017,DEB,Amazon UK Marketpl,4.99,,12889.64,Amazon,Swansea,Uk
4795,4796,26/09/2017,DEB,Amazon UK Marketpl,2.99,,12894.63,Amazon,Swansea,Uk
4796,4797,26/09/2017,DEB,Amazon UK Marketpl,2.51,,12897.62,Amazon,Swansea,Uk
4797,4798,25/09/2017,FPI,MARIANA MILLS,,180.0,12900.13,Supplementary Income,Swansea,Uk
4798,4799,25/09/2017,CPT,LNK UNI - UNIVERSI,100.0,,12720.13,Cash,Swansea,Uk
4799,4800,25/09/2017,BP,SAVE THE CHANGE,0.86,,12820.13,Savings,Swansea,Uk
4800,4801,22/09/2017,DEB,EASYJET   ESVS7J,380.94,,12820.99,Travel,,
4801,4802,22/09/2017,DEB,Amazon UK Marketpl,2.0,,13201.93,Amazon,Swansea,Uk
4802,4803,22/09/2017,DEB,DELIVEROOCOUK,20.2,,13203.93,Dine Out,,
4803,4804,22/09/2017,CPT,LNK UNI - UNIVERSI,50.0,,13224.13,Cash,Swansea,Uk
4804,4805,22/09/2017,BP,SAVE THE CHANGE,1.08,,13274.13,Savings,Swansea,Uk
4805,4806,21/09/2017,DEB,WATSON & PRATTS,140.67,,13275.21,Groceries,Lampeter,Uk
4806,4807,21/09/2017,DEB,Amazon UK Marketpl,6.25,,13415.88,Amazon,Swansea,Uk
4807,4808,21/09/2017,BP,SAVE THE CHANGE,0.01,,13422.13,Savings,Swansea,Uk
4808,4809,20/09/2017,DEB,Amazon UK Retail,12.99,,13422.14,Amazon,Swansea,Uk
4809,4810,19/09/2017,CPT,LNK UNI - UNIVERSI,50.0,,13435.13,Cash,Swansea,Uk
4810,4811,19/09/2017,BP,SAVE THE CHANGE,0.5,,13485.13,Savings,Swansea,Uk
4811,4812,18/09/2017,DEB,BIRMINGHAM INT HOT,47.5,,13485.63,Hotels,Birmingham,Uk
4812,4813,18/09/2017,DD,O2,29.36,,13533.13,Other Shopping,Swansea,Uk
4813,4814,18/09/2017,CPT,LNK ARRIVA TRAINS,50.0,,13562.49,Cash,,
4814,4815,14/09/2017,DEB,ARRIVA TRAINS WALE,89.0,,13612.49,Travel,,
4815,4816,13/09/2017,BP,SAVE THE CHANGE,0.52,,13701.49,Savings,Swansea,Uk
4816,4817,12/09/2017,DEB,Amazon UK Marketpl,1.48,,13702.01,Amazon,Swansea,Uk
4817,4818,12/09/2017,CPT,LNK UNI - UNIVERSI,50.0,,13703.49,Cash,Swansea,Uk
4818,4819,12/09/2017,BP,SAVE THE CHANGE,0.2,,13753.49,Savings,Swansea,Uk
4819,4820,11/09/2017,DEB,IZ *Brontosaurus V,31.8,,13753.69,Dine Out,,
4820,4821,11/09/2017,CPT,LNK UNI - UNIVERSI,50.0,,13785.49,Cash,Swansea,Uk
4821,4822,11/09/2017,BP,SAVE THE CHANGE,1.2,,13835.49,Savings,Swansea,Uk
4822,4823,11/09/2017,TFR,SERGEJS KATACINS,35.0,,13836.69,Services,Swansea,Uk
4823,4824,08/09/2017,DEB,PLUSNET PLC 0845 1,41.6,,13871.69,Entertainment,Swansea,Uk
4824,4825,08/09/2017,DEB,DELIVEROOCOUK,19.2,,13913.29,Dine Out,,
4825,4826,08/09/2017,DD,LV LIFE,37.12,,13932.49,Insurance,Swansea,Uk
4826,4827,08/09/2017,BP,SAVE THE CHANGE,0.99,,13969.61,Savings,Swansea,Uk
4827,4828,07/09/2017,DEB,BRITISH GAS TRADIN,83.66,,13970.6,Home Improvement,Swansea,Uk
4828,4829,07/09/2017,DEB,BRITISH GAS TRADIN,49.35,,14054.26,Home Improvement,Swansea,Uk
4829,4830,06/09/2017,BP,SAVE THE CHANGE,0.64,,14103.61,Savings,Swansea,Uk
4830,4831,05/09/2017,CPT,LNK SWANSEA WIND S,200.0,,14104.25,Cash,Swansea,Uk
4831,4832,05/09/2017,DEB,Amazon UK Marketpl,26.87,,14304.25,Amazon,Swansea,Uk
4832,4833,05/09/2017,DEB,Amazon UK Marketpl,2.49,,14331.12,Amazon,Swansea,Uk
4833,4834,05/09/2017,BP,SAVE THE CHANGE,2.77,,14333.61,Savings,Swansea,Uk
4834,4835,04/09/2017,CPT,LNK 1 UNION STREET,100.0,,14336.38,Cash,Leicester,Uk
4835,4836,04/09/2017,DEB,Amazon UK Marketpl,63.13,,14436.38,Amazon,Swansea,Uk
4836,4837,04/09/2017,DEB,Amazon UK Marketpl,10.14,,14499.51,Amazon,Swansea,Uk
4837,4838,04/09/2017,DEB,Amazon UK Retail,4.62,,14509.65,Amazon,Swansea,Uk
4838,4839,04/09/2017,DEB,TICKETS08712200260,95.34,,14514.27,Travel,,
4839,4840,04/09/2017,DEB,HENDON HALL HOTEL,114.0,,14609.61,Hotels,London,Uk
4840,4841,04/09/2017,DD,ASSURANT INTER LTD,21.47,,14723.61,Insurance,Swansea,Uk
4841,4842,04/09/2017,BP,SAVE THE CHANGE,0.7,,14745.08,Savings,Swansea,Uk
4842,4843,04/09/2017,TFR,SERGEJS KATACINS,182.0,,14745.78,Services,Swansea,Uk
4843,4844,01/09/2017,FEE,ACCOUNT FEE,9.95,,14927.78,Bills,Swansea,Uk
4844,4845,01/09/2017,DEB,ARRIVA TRAINS WALE,82.3,,14937.73,Travel,,
4845,4846,01/09/2017,DD,PRINCIPALITY BS,957.26,,15020.03,Mortgage,Swansea,Uk
4846,4847,01/09/2017,DD,CC SWANSEA C.TAX,174.0,,15977.29,Bills,Swansea,Uk
4847,4848,01/09/2017,DD,AVIVA LIFE,46.46,,16151.29,Insurance,Swansea,Uk
4848,4849,01/09/2017,DD,DWR CYMRU W WATER,33.5,,16197.75,Bills,Swansea,Uk
4849,4850,01/09/2017,SO,ESAVINGS ACCOUNT,300.0,,16231.25,Savings,Swansea,Uk
4850,4851,31/08/2017,CPT,LNK UNI - UNIVERSI,50.0,,16531.25,Cash,Swansea,Uk
4851,4852,31/08/2017,DD,UCU B ACCOUNT,22.7,,16581.25,Others,Swansea,Uk
4852,4853,31/08/2017,BP,SAVE THE CHANGE,0.41,,16603.95,Savings,Swansea,Uk
4853,4854,31/08/2017,BGC,SWANSEA UNI - PAY,,3180.97,16604.36,Paycheck,Swansea,Uk
4854,4855,30/08/2017,DEB,Amazon UK Marketpl,18.59,,13423.39,Amazon,Swansea,Uk
4855,4856,30/08/2017,BP,SAVE THE CHANGE,0.24,,13441.98,Savings,Swansea,Uk
4856,4857,29/08/2017,DEB,Amazon UK Retail,23.76,,13442.22,Amazon,Swansea,Uk
4857,4858,29/08/2017,DEB,PLUSNET PLC 0845 1,,5.07,13465.98,Supplementary Income,Swansea,Uk
4858,4859,29/08/2017,CPT,LNK UNI - UNIVERSI,50.0,,13460.91,Cash,Swansea,Uk
4859,4860,25/08/2017,DEB,VIRGIN MEDIA PYMTS,25.0,,13510.91,Bills,Nottingham,Uk
4860,4861,25/08/2017,BP,SAVE THE CHANGE,0.15,,13535.91,Savings,Swansea,Uk
4861,4862,24/08/2017,DEB,4500 MILES,28.85,,13536.06,Dine Out,,
4862,4863,24/08/2017,BGC,PLUSNET PLC PAY AC,,9.0,13564.91,Supplementary Income,Swansea,Uk
4863,4864,23/08/2017,CPT,LNK TESCO BLEN CRT,30.0,,13555.91,Cash,Bristol,Uk
4864,4865,23/08/2017,BP,SAVE THE CHANGE,0.1,,13585.91,Savings,Swansea,Uk
4865,4866,22/08/2017,DEB,THE LANGLEY ARMS,150.0,,13586.01,Travel,,
4866,4867,22/08/2017,DEB,ARRIVA TRAINS WALE,36.9,,13736.01,Travel,,
4867,4868,21/08/2017,CPT,LNK ARRIVA TRAINS,60.0,,13772.91,Cash,,
4868,4869,21/08/2017,DEB,IKEA ONLINE,194.0,,13832.91,Other Shopping,,
4869,4870,21/08/2017,DEB,AMZ*Globoshop,,48.99,14026.91,Supplementary Income,Swansea,Uk
4870,4871,18/08/2017,CPT,LNK UNI - UNIVERSI,50.0,,13977.92,Cash,Swansea,Uk
4871,4872,17/08/2017,CPT,LNK ARRIVA TRAINS,60.0,,14027.92,Cash,,
4872,4873,17/08/2017,DD,PNET3444685-1,18.99,,14087.92,Others,Swansea,Uk
4873,4874,16/08/2017,CPT,LNK UNI - UNIVERSI,250.0,,14106.91,Cash,Swansea,Uk
4874,4875,16/08/2017,DD,O2,24.42,,14356.91,Other Shopping,Swansea,Uk
4875,4876,16/08/2017,DD,PNET3444685-1,9.0,,14381.33,Others,Swansea,Uk
4876,4877,16/08/2017,BP,SAVE THE CHANGE,0.05,,14390.33,Savings,Swansea,Uk
4877,4878,15/08/2017,DEB,AMAZON UK RETAIL A,23.95,,14390.38,Amazon,Swansea,Uk
4878,4879,15/08/2017,CPT,LNK UNI - UNIVERSI,80.0,,14414.33,Cash,Swansea,Uk
4879,4880,15/08/2017,BP,SAVE THE CHANGE,0.01,,14494.33,Savings,Swansea,Uk
4880,4881,14/08/2017,DEB,AMAZON.CO.UK,11.99,,14494.34,Amazon,Swansea,Uk
4881,4882,14/08/2017,DEB,BRITANNIA,49.0,,14506.33,Amazon,Swansea,Uk
4882,4883,11/08/2017,DEB,AMZ*Discounted Cle,,10.58,14555.33,Supplementary Income,Swansea,Uk
4883,4884,11/08/2017,CHQ,52,90.0,,14544.75,Cash,,
4884,4885,11/08/2017,BP,SAVE THE CHANGE,0.04,,14634.75,Savings,Swansea,Uk
4885,4886,10/08/2017,CPT,LNK TESCO SWANSEA,60.0,,14634.79,Cash,Swansea,Uk
4886,4887,10/08/2017,DEB,Amazon UK Retail,15.96,,14694.79,Amazon,Swansea,Uk
4887,4888,10/08/2017,BP,SAVE THE CHANGE,0.51,,14710.75,Savings,Swansea,Uk
4888,4889,09/08/2017,DEB,Amazon UK Retail,5.49,,14711.26,Amazon,Swansea,Uk
4889,4890,09/08/2017,DD,LV LIFE,37.12,,14716.75,Insurance,Swansea,Uk
4890,4891,09/08/2017,BP,SAVE THE CHANGE,0.81,,14753.87,Savings,Swansea,Uk
4891,4892,08/08/2017,DEB,Amazon UK Marketpl,8.39,,14754.68,Amazon,Swansea,Uk
4892,4893,08/08/2017,DEB,THE HEALTH SHOP,38.8,,14763.07,Other Shopping,,
4893,4894,08/08/2017,CPT,LNK UNI - UNIVERSI,50.0,,14801.87,Cash,Swansea,Uk
4894,4895,08/08/2017,BP,SAVE THE CHANGE,0.81,,14851.87,Savings,Swansea,Uk
4895,4896,07/08/2017,DEB,IZ *Brontosaurus V,16.19,,14852.68,Dine Out,,
4896,4897,07/08/2017,BP,SAVE THE CHANGE,2.57,,14868.87,Savings,Swansea,Uk
4897,4898,07/08/2017,DEB,NON-STG PURCH FEE,0.5,,14871.44,Others,Swansea,Uk
4898,4899,07/08/2017,DEB,NON-STG TRANS FEE,5.36,,14871.94,Others,Swansea,Uk
4899,4900,07/08/2017,DEB,HYATT REGENCY PHOE,179.44,,14877.3,Hotels,Phoenix,Usa
4900,4901,04/08/2017,DEB,Amazon UK Marketpl,6.26,,15056.74,Amazon,Swansea,Uk
4901,4902,04/08/2017,DEB,Amazon UK Retail,5.46,,15063.0,Amazon,Swansea,Uk
4902,4903,04/08/2017,DEB,Amazon UK Marketpl,5.27,,15068.46,Amazon,Swansea,Uk
4903,4904,04/08/2017,CPT,LNK UNI - UNIVERSI,50.0,,15073.73,Cash,Swansea,Uk
4904,4905,04/08/2017,DD,ASSURANT INTER LTD,39.74,,15123.73,Insurance,Swansea,Uk
4905,4906,04/08/2017,BP,SAVE THE CHANGE,0.71,,15163.47,Savings,Swansea,Uk
4906,4907,03/08/2017,DEB,THE PRINCIPAL MANC,267.3,,15164.18,Dine Out,Manchester,Uk
4907,4908,03/08/2017,DEB,Amazon UK Marketpl,48.99,,15431.48,Amazon,Swansea,Uk
4908,4909,03/08/2017,DEB,AMZ*Dealsdirect247,,15.99,15480.47,Supplementary Income,Swansea,Uk
4909,4910,03/08/2017,BP,SAVE THE CHANGE,0.9,,15464.48,Savings,Swansea,Uk
4910,4911,02/08/2017,DEB,SPRINGFIELD DEVELO,160.0,,15465.38,Home Improvement,Swansea,Uk
4911,4912,02/08/2017,DEB,SWANSEA UNI - CATE,3.1,,15625.38,Dine Out,Swansea,Uk
4912,4913,02/08/2017,BP,SAVE THE CHANGE,0.4,,15628.48,Savings,Swansea,Uk
4913,4914,01/08/2017,FEE,ACCOUNT FEE,9.95,,15628.88,Bills,Swansea,Uk
4914,4915,01/08/2017,DEB,GWR WEBSALES,78.6,,15638.83,Travel,,
4915,4916,01/08/2017,CPT,LNK 404331M&S SWAN,80.0,,15717.43,Cash,Swansea,Uk
4916,4917,01/08/2017,DD,PRINCIPALITY BS,1159.25,,15797.43,Mortgage,Swansea,Uk
4917,4918,01/08/2017,DD,CC SWANSEA C.TAX,174.0,,16956.68,Bills,Swansea,Uk
4918,4919,01/08/2017,DD,AVIVA LIFE,46.46,,17130.68,Insurance,Swansea,Uk
4919,4920,01/08/2017,DD,DWR CYMRU W WATER,33.5,,17177.14,Bills,Swansea,Uk
4920,4921,01/08/2017,SO,ESAVINGS ACCOUNT,300.0,,17210.64,Savings,Swansea,Uk
4921,4922,01/08/2017,BP,SAVE THE CHANGE,1.89,,17510.64,Savings,Swansea,Uk
4922,4923,31/07/2017,DEB,Amazon UK Marketpl,26.25,,17512.53,Amazon,Swansea,Uk
4923,4924,31/07/2017,DEB,Amazon UK Marketpl,1.27,,17538.78,Amazon,Swansea,Uk
4924,4925,31/07/2017,DEB,IKEA ONLINE,360.0,,17540.05,Other Shopping,,
4925,4926,31/07/2017,DEB,CITY PLUMBING SUPP,153.59,,17900.05,Home Improvement,Swansea,Uk
4926,4927,31/07/2017,DD,UCU B ACCOUNT,22.7,,18053.64,Others,Swansea,Uk
4927,4928,31/07/2017,BP,SAVE THE CHANGE,0.82,,18076.34,Savings,Swansea,Uk
4928,4929,31/07/2017,BGC,SWANSEA UNI - PAY,,3138.66,18077.16,Paycheck,Swansea,Uk
4929,4930,28/07/2017,DEB,AMAZON.CO.UK,11.96,,14938.5,Amazon,Swansea,Uk
4930,4931,28/07/2017,DEB,AMAZON UK RETAIL A,7.38,,14950.46,Amazon,Swansea,Uk
4931,4932,28/07/2017,DEB,AMAZON.CO.UK,13.84,,14957.84,Amazon,Swansea,Uk
4932,4933,28/07/2017,CPT,LNK UNI - UNIVERSI,50.0,,14971.68,Cash,Swansea,Uk
4933,4934,25/07/2017,CPT,LNK UNI - UNIVERSI,50.0,,15021.68,Cash,Swansea,Uk
4934,4935,21/07/2017,CPT,LNK UNI - UNIVERSI,50.0,,15071.68,Cash,Swansea,Uk
4935,4936,21/07/2017,DD,VIRGIN MEDIA PYMTS,30.97,,15121.68,Bills,Nottingham,Uk
4936,4937,21/07/2017,BGC,SWANSEA UNIVERSITY,,1004.43,15152.65,Supplementary Income,Swansea,Uk
4937,4938,20/07/2017,DD,GOOD ENERGY LTD,124.74,,14148.22,Bills,Nottingham,Uk
4938,4939,19/07/2017,CPT,LNK UNI - UNIVERSI,50.0,,14272.96,Cash,Swansea,Uk
4939,4940,17/07/2017,DD,O2,26.73,,14322.96,Other Shopping,Swansea,Uk
4940,4941,14/07/2017,BP,SAVE THE CHANGE,0.5,,14349.69,Savings,Swansea,Uk
4941,4942,13/07/2017,DEB,Amazon UK Marketpl,6.5,,14350.19,Amazon,Swansea,Uk
4942,4943,13/07/2017,DD,AVIVA LIFE,46.46,,14356.69,Insurance,Swansea,Uk
4943,4944,13/07/2017,BP,SAVE THE CHANGE,0.98,,14403.15,Savings,Swansea,Uk
4944,4945,12/07/2017,DEB,Amazon UK Marketpl,10.66,,14404.13,Amazon,Swansea,Uk
4945,4946,12/07/2017,DEB,Amazon UK Marketpl,10.36,,14414.79,Amazon,Swansea,Uk
4946,4947,12/07/2017,BP,SAVE THE CHANGE,0.44,,14425.15,Savings,Swansea,Uk
4947,4948,11/07/2017,DEB,PLUSNET PLC 0845 1,68.98,,14425.59,Entertainment,Swansea,Uk
4948,4949,11/07/2017,DEB,Amazon UK Marketpl,10.58,,14494.57,Amazon,Swansea,Uk
4949,4950,11/07/2017,BP,SAVE THE CHANGE,1.18,,14505.15,Savings,Swansea,Uk
4950,4951,10/07/2017,DEB,Amazon UK Retail,13.66,,14506.33,Entertainment,Swansea,Uk
4951,4952,10/07/2017,DEB,Amazon UK Retail,17.84,,14519.99,Amazon,Swansea,Uk
4952,4953,10/07/2017,DEB,Amazon UK Marketpl,2.62,,14537.83,Amazon,Swansea,Uk
4953,4954,10/07/2017,DEB,Amazon UK Marketpl,1.7,,14540.45,Amazon,Swansea,Uk
4954,4955,10/07/2017,DD,LVFS LTD A A/C,37.12,,14542.15,Insurance,Swansea,Uk
4955,4956,07/07/2017,CPT,LNK UNI - UNIVERSI,100.0,,14579.27,Cash,Swansea,Uk
4956,4957,07/07/2017,CHQ,LOYD 802 OXFORD ST,,1003.79,14679.27,Supplementary Income,Swansea,Uk
4957,4958,07/07/2017,BP,SAVE THE CHANGE,0.22,,13675.48,Savings,Swansea,Uk
4958,4959,06/07/2017,DEB,Amazon UK Marketpl,16.78,,13675.7,Amazon,Swansea,Uk
4959,4960,06/07/2017,TFR,F/FLOW NATWEST BAN,,828.49,13692.48,Supplementary Income,Swansea,Uk
4960,4961,06/07/2017,CPT,LNK UNI - UNIVERSI,200.0,,12863.99,Cash,Swansea,Uk
4961,4962,06/07/2017,BP,SAVE THE CHANGE,0.56,,13063.99,Savings,Swansea,Uk
4962,4963,05/07/2017,DEB,Amazon UK Marketpl,14.44,,13064.55,Amazon,Swansea,Uk
4963,4964,05/07/2017,BP,SAVE THE CHANGE,0.01,,13078.99,Savings,Swansea,Uk
4964,4965,04/07/2017,DEB,AMAZON.CO.UK,16.99,,13079.0,Amazon,Swansea,Uk
4965,4966,04/07/2017,BP,SAVE THE CHANGE,0.76,,13095.99,Savings,Swansea,Uk
4966,4967,03/07/2017,FEE,ACCOUNT FEE,9.95,,13096.75,Bills,Swansea,Uk
4967,4968,03/07/2017,DEB,Amazon UK Marketpl,20.24,,13106.7,Amazon,Swansea,Uk
4968,4969,03/07/2017,DD,NATWEST BANK,828.49,,13126.94,Mortgage,Swansea,Uk
4969,4970,03/07/2017,DD,CC SWANSEA C.TAX,174.0,,13955.43,Bills,Swansea,Uk
4970,4971,03/07/2017,DD,GOOD ENERGY LTD,85.0,,14129.43,Bills,Swansea,Uk
4971,4972,03/07/2017,DD,ASSURANT INTER LTD,39.74,,14214.43,Insurance,Swansea,Uk
4972,4973,03/07/2017,DD,DWR CYMRU W WATER,32.5,,14254.17,Bills,Swansea,Uk
4973,4974,03/07/2017,DD,TV LICENCE MBP,12.37,,14286.67,Bills,Swansea,Uk
4974,4975,03/07/2017,SO,ESAVINGS ACCOUNT,300.0,,14299.04,Savings,Swansea,Uk
4975,4976,03/07/2017,BGC,SWANSEA UNIVERSITY,,319.45,14599.04,Supplementary Income,Swansea,Uk
4976,4977,30/06/2017,DD,UCU B ACCOUNT,22.7,,14279.59,Others,Swansea,Uk
4977,4978,30/06/2017,BP,SAVE THE CHANGE,0.64,,14302.29,Savings,Swansea,Uk
4978,4979,30/06/2017,BGC,SWANSEA UNI - PAY,,3138.65,14302.93,Paycheck,Swansea,Uk
4979,4980,29/06/2017,CPT,LNK UNI - UNIVERSI,250.0,,11164.28,Cash,Swansea,Uk
4980,4981,29/06/2017,DEB,POST OFFICE COUNTE,62.99,,11414.28,Others,Swansea,Uk
4981,4982,29/06/2017,DEB,Amazon UK Marketpl,16.99,,11477.27,Amazon,Swansea,Uk
4982,4983,29/06/2017,DEB,Amazon UK Marketpl,13.8,,11494.26,Amazon,Swansea,Uk
4983,4984,29/06/2017,DEB,Amazon UK Marketpl,5.58,,11508.06,Amazon,Swansea,Uk
4984,4985,29/06/2017,FPO,DEZREZ LEGAL LTD,5619.03,,11513.64,Mortgage,Nottingham,Uk
4985,4986,29/06/2017,BP,SAVE THE CHANGE,0.86,,17132.67,Savings,Swansea,Uk
4986,4987,28/06/2017,DEB,Amazon UK Marketpl,26.15,,17133.53,Amazon,Swansea,Uk
4987,4988,28/06/2017,DEB,AMAZON UK RETAIL A,6.99,,17159.68,Amazon,Swansea,Uk
4988,4989,28/06/2017,BP,SAVE THE CHANGE,0.99,,17166.67,Savings,Swansea,Uk
4989,4990,27/06/2017,DEB,Amazon UK Marketpl,19.95,,17167.66,Amazon,Swansea,Uk
4990,4991,27/06/2017,DEB,Amazon UK Retail,7.15,,17187.61,Amazon,Swansea,Uk
4991,4992,27/06/2017,DEB,Amazon UK Marketpl,3.91,,17194.76,Amazon,Swansea,Uk
4992,4993,27/06/2017,CPT,LNK UNI - UNIVERSI,50.0,,17198.67,Cash,Swansea,Uk
4993,4994,27/06/2017,BP,SAVE THE CHANGE,0.8,,17248.67,Savings,Swansea,Uk
4994,4995,26/06/2017,DEB,JS ONLINE GROCERY,323.2,,17249.47,Groceries,Swansea,Uk
4995,4996,26/06/2017,DEP,SKETTY SWANSEA,,211.5,17572.67,Supplementary Income,Swansea,Uk
4996,4997,26/06/2017,BP,SAVE THE CHANGE,0.01,,17361.17,Savings,Swansea,Uk
4997,4998,23/06/2017,DEB,Amazon UK Marketpl,12.99,,17361.18,Amazon,Swansea,Uk
4998,4999,23/06/2017,CPT,LNK UNI - UNIVERSI,20.0,,17374.17,Cash,Swansea,Uk
4999,5000,22/06/2017,DD,CORGI HOMEPLAN CA,19.5,,17394.17,Home Improvement,Swansea,Uk
5000,5001,21/06/2017,FPI,MARIANA MILLS,,375.0,17413.67,Supplementary Income,Swansea,Uk
5001,5002,21/06/2017,CPT,LNK UNI - UNIVERSI,50.0,,17038.67,Cash,Swansea,Uk
5002,5003,21/06/2017,DD,VIRGIN MEDIA PYMTS,39.58,,17088.67,Bills,Nottingham,Uk
5003,5004,21/06/2017,BP,SAVE THE CHANGE,0.75,,17128.25,Savings,Swansea,Uk
5004,5005,20/06/2017,DEB,Amazon UK Marketpl,15.99,,17129.0,Amazon,Swansea,Uk
5005,5006,20/06/2017,DEB,Amazon UK Marketpl,11.26,,17144.99,Amazon,Swansea,Uk
5006,5007,20/06/2017,BP,SAVE THE CHANGE,2.29,,17156.25,Savings,Swansea,Uk
5007,5008,19/06/2017,DEB,Amazon UK Marketpl,80.16,,17158.54,Amazon,Swansea,Uk
5008,5009,19/06/2017,DEB,Amazon UK Retail,78.97,,17238.7,Amazon,Swansea,Uk
5009,5010,19/06/2017,DEB,Amazon UK Retail,44.96,,17317.67,Amazon,Swansea,Uk
5010,5011,19/06/2017,DEB,Amazon UK Marketpl,27.6,,17362.63,Amazon,Swansea,Uk
5011,5012,19/06/2017,DEB,AMAZON UK RETAIL A,19.98,,17390.23,Amazon,Swansea,Uk
5012,5013,19/06/2017,DEB,Amazon UK Marketpl,5.04,,17410.21,Amazon,Swansea,Uk
5013,5014,19/06/2017,DEB,COOL FISH RIDES S,,136.16,17415.25,Supplementary Income,Swansea,Uk
5014,5015,19/06/2017,BP,SAVE THE CHANGE,0.94,,17279.09,Savings,Swansea,Uk
5015,5016,16/06/2017,DEB,COOL FISH RIDES S,138.52,,17280.03,Entertainment,London,Uk
5016,5017,16/06/2017,DEB,COOL FISH RIDES S,5.54,,17418.55,Entertainment,London,Uk
5017,5018,16/06/2017,DD,O2,20.79,,17424.09,Other Shopping,Swansea,Uk
5018,5019,13/06/2017,DEB,FOREIGN CASH FEE,2.0,,17444.88,Travel,,
5019,5020,13/06/2017,DEB,101823784,92.25,,17446.88,Others,Swansea,Uk
5020,5021,13/06/2017,BP,SAVE THE CHANGE,1.11,,17539.13,Savings,Swansea,Uk
5021,5022,12/06/2017,DEB,ARRIVA TRAINS WALE,8.2,,17540.24,Travel,,
5022,5023,12/06/2017,DEB,Amazon UK Retail,9.69,,17548.44,Amazon,Swansea,Uk
5023,5024,12/06/2017,BP,SAVE THE CHANGE,0.49,,17558.13,Savings,Swansea,Uk
5024,5025,12/06/2017,CPT,LNK ARRIVA TRAINS,60.0,,17558.62,Cash,,
5025,5026,09/06/2017,CPT,LNK UNI - UNIVERSI,50.0,,17618.62,Cash,Swansea,Uk
5026,5027,09/06/2017,DEB,Amazon UK Marketpl,9.51,,17668.62,Amazon,Swansea,Uk
5027,5028,09/06/2017,DD,LV LIFE,37.12,,17678.13,Insurance,Swansea,Uk
5028,5029,09/06/2017,BP,SAVE THE CHANGE,0.1,,17715.25,Savings,Swansea,Uk
5029,5030,08/06/2017,DEB,WWW.DEZREZLEGAL.CO,245.0,,17715.35,Insurance,Swansea,Uk
5030,5031,08/06/2017,DEB,WATSON & PRATTS,128.9,,17960.35,Groceries,Lampeter,Uk
5031,5032,07/06/2017,BP,SAVE THE CHANGE,0.84,,18089.25,Savings,Swansea,Uk
5032,5033,06/06/2017,DEB,Amazon UK Marketpl,8.16,,18090.09,Amazon,Swansea,Uk
5033,5034,06/06/2017,CPT,LNK UNI - UNIVERSI,100.0,,18098.25,Cash,Swansea,Uk
5034,5035,06/06/2017,BP,SAVE THE CHANGE,1.61,,18198.25,Savings,Swansea,Uk
5035,5036,05/06/2017,DEB,Amazon UK Marketpl,6.44,,18199.86,Amazon,Swansea,Uk
5036,5037,05/06/2017,DEB,Amazon UK Marketpl,12.44,,18206.3,Amazon,Swansea,Uk
5037,5038,05/06/2017,DEB,Amazon Svcs Europe,8.52,,18218.74,Amazon,Swansea,Uk
5038,5039,05/06/2017,DEB,AMAZON.CO.UK,6.99,,18227.26,Amazon,Swansea,Uk
5039,5040,05/06/2017,DD,ASSURANT INTER LTD,39.74,,18234.25,Insurance,Swansea,Uk
5040,5041,05/06/2017,BP,SAVE THE CHANGE,0.55,,18273.99,Savings,Swansea,Uk
5041,5042,02/06/2017,DEB,AMAZON.CO.UK,18.45,,18274.54,Amazon,Swansea,Uk
5042,5043,02/06/2017,CPT,LNK UNI - UNIVERSI,40.0,,18292.99,Cash,Swansea,Uk
5043,5044,01/06/2017,FEE,ACCOUNT FEE,9.95,,18332.99,Bills,Swansea,Uk
5044,5045,01/06/2017,CPT,LNK UNI - UNIVERSI,50.0,,18342.94,Cash,Swansea,Uk
5045,5046,01/06/2017,DD,NATWEST BANK,828.49,,18392.94,Mortgage,Swansea,Uk
5046,5047,01/06/2017,DD,CC SWANSEA C.TAX,174.0,,19221.43,Bills,Swansea,Uk
5047,5048,01/06/2017,DD,GOOD ENERGY LTD,85.0,,19395.43,Bills,Swansea,Uk
5048,5049,01/06/2017,DD,DWR CYMRU W WATER,32.5,,19480.43,Bills,Swansea,Uk
5049,5050,01/06/2017,DD,TV LICENCE MBP,12.37,,19512.93,Bills,Swansea,Uk
5050,5051,01/06/2017,SO,ESAVINGS ACCOUNT,300.0,,19525.3,Savings,Swansea,Uk
5051,5052,31/05/2017,DD,UCU B ACCOUNT,22.7,,19825.3,Others,Swansea,Uk
5052,5053,31/05/2017,BP,SAVE THE CHANGE,0.4,,19848.0,Savings,Swansea,Uk
5053,5054,31/05/2017,BGC,SWANSEA UNI - PAY,,3138.65,19848.4,Paycheck,Swansea,Uk
5054,5055,30/05/2017,DEB,ARRIVA TRAINS WALE,166.6,,16709.75,Travel,,
5055,5056,30/05/2017,BP,SAVE THE CHANGE,0.51,,16876.35,Savings,Swansea,Uk
5056,5057,30/05/2017,CPT,LNK RAIL BRISTOL T,50.0,,16876.86,Cash,Bristol,Uk
5057,5058,26/05/2017,DEB,Amazon UK Retail,9.99,,16926.86,Amazon,Swansea,Uk
5058,5059,26/05/2017,DEB,AMAZON UK RETAIL A,12.5,,16936.85,Amazon,Swansea,Uk
5059,5060,26/05/2017,CPT,LNK UNI - UNIVERSI,80.0,,16949.35,Cash,Swansea,Uk
5060,5061,26/05/2017,BP,SAVE THE CHANGE,1.49,,17029.35,Savings,Swansea,Uk
5061,5062,25/05/2017,CPT,LNK UPLANDS CRESCE,100.0,,17030.84,Cash,Swansea,Uk
5062,5063,25/05/2017,DEB,AMAZON UK RETAIL A,8.16,,17130.84,Amazon,Swansea,Uk
5063,5064,25/05/2017,DEB,Amazon UK Marketpl,2.35,,17139.0,Amazon,Swansea,Uk
5064,5065,25/05/2017,BP,SAVE THE CHANGE,0.12,,17141.35,Savings,Swansea,Uk
5065,5066,24/05/2017,DEB,Amazon UK Marketpl,6.96,,17141.47,Amazon,Swansea,Uk
5066,5067,24/05/2017,DEB,AMAZON UK RETAIL A,10.92,,17148.43,Amazon,Swansea,Uk
5067,5068,24/05/2017,BP,SAVE THE CHANGE,1.45,,17159.35,Savings,Swansea,Uk
5068,5069,23/05/2017,DEB,Amazon UK Marketpl,16.06,,17160.8,Amazon,Swansea,Uk
5069,5070,23/05/2017,DEB,AMAZON UK RETAIL A,10.49,,17176.86,Amazon,Swansea,Uk
5070,5071,23/05/2017,CPT,LNK UNI - UNIVERSI,60.0,,17187.35,Cash,Swansea,Uk
5071,5072,23/05/2017,BP,SAVE THE CHANGE,0.01,,17247.35,Savings,Swansea,Uk
5072,5073,22/05/2017,DEB,Amazon UK Marketpl,6.99,,17247.36,Amazon,Swansea,Uk
5073,5074,22/05/2017,DD,VIRGIN MEDIA PYMTS,31.48,,17254.35,Bills,Nottingham,Uk
5074,5075,22/05/2017,DD,CORGI HOMEPLAN CA,19.5,,17285.83,Home Improvement,Swansea,Uk
5075,5076,22/05/2017,BP,SAVE THE CHANGE,1.51,,17305.33,Savings,Swansea,Uk
5076,5077,19/05/2017,DEB,ARRIVA TRAINS WALE,22.4,,17306.84,Travel,,
5077,5078,19/05/2017,DEB,Amazon UK Retail,5.75,,17329.24,Amazon,Swansea,Uk
5078,5079,19/05/2017,DEB,AMAZON UK RETAIL A,11.34,,17334.99,Amazon,Swansea,Uk
5079,5080,19/05/2017,BP,SAVE THE CHANGE,0.71,,17346.33,Savings,Swansea,Uk
5080,5081,18/05/2017,DEB,AMAZON.CO.UK,15.29,,17347.04,Amazon,Swansea,Uk
5081,5082,18/05/2017,CPT,LNK UNI - UNIVERSI,100.0,,17362.33,Cash,Swansea,Uk
5082,5083,17/05/2017,BP,SAVE THE CHANGE,0.02,,17462.33,Savings,Swansea,Uk
5083,5084,16/05/2017,DEB,Amazon UK Retail,23.98,,17462.35,Amazon,Swansea,Uk
5084,5085,16/05/2017,CPT,LNK UNI - UNIVERSI,100.0,,17486.33,Cash,Swansea,Uk
5085,5086,16/05/2017,DD,O2,18.06,,17586.33,Other Shopping,Swansea,Uk
5086,5087,16/05/2017,BP,SAVE THE CHANGE,0.01,,17604.39,Savings,Swansea,Uk
5087,5088,15/05/2017,DEB,Amazon UK Marketpl,7.99,,17604.4,Amazon,Swansea,Uk
5088,5089,15/05/2017,DEB,WWW.DEZREZLEGAL.CO,50.0,,17612.39,Insurance,Swansea,Uk
5089,5090,15/05/2017,CPT,LNK UNI - UNIVERSI,50.0,,17662.39,Cash,Swansea,Uk
5090,5091,12/05/2017,CPT,LNK UNI - UNIVERSI,30.0,,17712.39,Cash,Swansea,Uk
5091,5092,09/05/2017,CPT,LNK SWANSEA WIND S,50.0,,17742.39,Cash,Swansea,Uk
5092,5093,09/05/2017,DEB,TICKETS08712200260,33.0,,17792.39,Travel,,
5093,5094,08/05/2017,DEB,PERSIMMON HOMES WE,200.0,,17825.39,Home Improvement,Swansea,Uk
5094,5095,08/05/2017,DD,LV LIFE,37.12,,18025.39,Insurance,Swansea,Uk
5095,5096,05/05/2017,DEB,WWW.DEZREZLEGAL.CO,25.0,,18062.51,Insurance,Swansea,Uk
5096,5097,05/05/2017,CPT,LOYD TALIESIN BUIL,50.0,,18087.51,Cash,,
5097,5098,03/05/2017,DD,ASSURANT INTER LTD,39.74,,18137.51,Insurance,Swansea,Uk
5098,5099,03/05/2017,BP,SAVE THE CHANGE,1.13,,18177.25,Savings,Swansea,Uk
5099,5100,02/05/2017,FEE,ACCOUNT FEE,9.95,,18178.38,Bills,Swansea,Uk
5100,5101,02/05/2017,DEB,GRUPO HOTELES PLAY,607.58,,18188.33,Hotels,Almería,Spain
5101,5102,02/05/2017,DEB,SUSU TRADING LTD,37.29,,18795.91,Home Improvement,Swansea,Uk
5102,5103,02/05/2017,CPT,LNK UNI - UNIVERSI,50.0,,18833.2,Cash,Swansea,Uk
5103,5104,02/05/2017,DD,NATWEST BANK,828.49,,18883.2,Mortgage,Swansea,Uk
5104,5105,02/05/2017,DD,CC SWANSEA C.TAX,174.0,,19711.69,Bills,Swansea,Uk
5105,5106,02/05/2017,DD,GOOD ENERGY LTD,85.0,,19885.69,Bills,Swansea,Uk
5106,5107,02/05/2017,DD,DWR CYMRU W WATER,32.5,,19970.69,Bills,Swansea,Uk
5107,5108,02/05/2017,DD,TV LICENCE MBP,12.12,,20003.19,Bills,Swansea,Uk
5108,5109,02/05/2017,SO,ESAVINGS ACCOUNT,300.0,,20015.31,Savings,Swansea,Uk
5109,5110,02/05/2017,BGC,SWANSEA UNIVERSITY,,692.67,20315.31,Supplementary Income,Swansea,Uk
5110,5111,28/04/2017,CPT,LNK UNI - UNIVERSI,30.0,,19622.64,Cash,Swansea,Uk
5111,5112,28/04/2017,DD,UCU B ACCOUNT,22.7,,19652.64,Others,Swansea,Uk
5112,5113,28/04/2017,BGC,SWANSEA UNI - PAY,,3138.66,19675.34,Paycheck,Swansea,Uk
5113,5114,26/04/2017,BP,SAVE THE CHANGE,0.03,,16536.68,Savings,Swansea,Uk
5114,5115,25/04/2017,DEB,Amazon UK Marketpl,15.97,,16536.71,Amazon,Swansea,Uk
5115,5116,25/04/2017,CPT,LNK UNI - UNIVERSI,40.0,,16552.68,Cash,Swansea,Uk
5116,5117,25/04/2017,DD,CORGI HOMEPLAN CA,19.5,,16592.68,Home Improvement,Swansea,Uk
5117,5118,25/04/2017,BP,SAVE THE CHANGE,0.6,,16612.18,Savings,Swansea,Uk
5118,5119,24/04/2017,DEB,AMAZON UK RETAIL A,10.81,,16612.78,Amazon,Swansea,Uk
5119,5120,24/04/2017,DEB,KLM UK  074132,265.59,,16623.59,Travel,,
5120,5121,24/04/2017,DEB,EXPEDIA 7260559230,3.0,,16889.18,Travel,,
5121,5122,21/04/2017,CPT,LNK UNI - UNIVERSI,30.0,,16892.18,Cash,Swansea,Uk
5122,5123,21/04/2017,DD,VIRGIN MEDIA PYMTS,31.48,,16922.18,Bills,Nottingham,Uk
5123,5124,21/04/2017,BP,SAVE THE CHANGE,0.01,,16953.66,Savings,Swansea,Uk
5124,5125,20/04/2017,DEB,Amazon Svcs Europe,4.99,,16953.67,Amazon,Swansea,Uk
5125,5126,20/04/2017,BP,SAVE THE CHANGE,0.74,,16958.66,Savings,Swansea,Uk
5126,5127,19/04/2017,DEB,Amazon UK Marketpl,37.71,,16959.4,Amazon,Swansea,Uk
5127,5128,19/04/2017,DEB,Amazon UK Marketpl,5.8,,16997.11,Amazon,Swansea,Uk
5128,5129,19/04/2017,DEB,Amazon UK Marketpl,5.75,,17002.91,Amazon,Swansea,Uk
5129,5130,19/04/2017,CPT,LNK LIFESTYLE EXPR,250.0,,17008.66,Cash,Leicester,Uk
5130,5131,19/04/2017,CPT,LNK UNI - UNIVERSI,40.0,,17258.66,Cash,Swansea,Uk
5131,5132,19/04/2017,DD,O2,31.13,,17298.66,Other Shopping,Swansea,Uk
5132,5133,19/04/2017,BP,SAVE THE CHANGE,0.77,,17329.79,Savings,Swansea,Uk
5133,5134,18/04/2017,DEB,AMAZON UK RETAIL A,3.99,,17330.56,Amazon,Swansea,Uk
5134,5135,18/04/2017,DEB,Amazon UK Marketpl,3.24,,17334.55,Amazon,Swansea,Uk
5135,5136,18/04/2017,BGC,SWANSEA UNIVERSITY,,151.28,17337.79,Supplementary Income,Swansea,Uk
5136,5137,18/04/2017,CPT,LNK SALUBRIOUS PLA,40.0,,17186.51,Cash,,
5137,5138,13/04/2017,CPT,LNK UNI - UNIVERSI,80.0,,17226.51,Cash,Swansea,Uk
5138,5139,13/04/2017,BP,SAVE THE CHANGE,0.45,,17306.51,Savings,Swansea,Uk
5139,5140,12/04/2017,DEB,Amazon UK Marketpl,13.93,,17306.96,Amazon,Swansea,Uk
5140,5141,12/04/2017,DEB,Amazon UK Marketpl,6.62,,17320.89,Amazon,Swansea,Uk
5141,5142,12/04/2017,BP,SAVE THE CHANGE,0.91,,17327.51,Savings,Swansea,Uk
5142,5143,11/04/2017,DEB,Amazon UK Marketpl,11.09,,17328.42,Amazon,Swansea,Uk
5143,5144,11/04/2017,BP,SAVE THE CHANGE,0.67,,17339.51,Savings,Swansea,Uk
5144,5145,10/04/2017,DEB,JS ONLINE GROCERY,315.35,,17340.18,Groceries,Swansea,Uk
5145,5146,10/04/2017,DEB,Amazon UK Marketpl,10.98,,17655.53,Amazon,Swansea,Uk
5146,5147,10/04/2017,DD,LV LIFE,37.12,,17666.51,Insurance,Swansea,Uk
5147,5148,07/04/2017,CPT,LNK UNI - UNIVERSI,40.0,,17703.63,Cash,Swansea,Uk
5148,5149,07/04/2017,BP,SAVE THE CHANGE,0.75,,17743.63,Savings,Swansea,Uk
5149,5150,06/04/2017,DEB,WATSON & PRATTS,138.25,,17744.38,Groceries,Lampeter,Uk
5150,5151,05/04/2017,CPT,LNK UNI - UNIVERSI,50.0,,17882.63,Cash,Swansea,Uk
5151,5152,05/04/2017,BP,SAVE THE CHANGE,0.04,,17932.63,Savings,Swansea,Uk
5152,5153,04/04/2017,DEB,AMAZON UK RETAIL A,104.98,,17932.67,Amazon,Swansea,Uk
5153,5154,04/04/2017,DEB,Amazon UK Marketpl,17.98,,18037.65,Amazon,Swansea,Uk
5154,5155,04/04/2017,BP,SAVE THE CHANGE,0.12,,18055.63,Savings,Swansea,Uk
5155,5156,03/04/2017,FEE,ACCOUNT FEE,9.95,,18055.75,Bills,Swansea,Uk
5156,5157,03/04/2017,DEB,Amazon UK Marketpl,15.99,,18065.7,Amazon,Swansea,Uk
5157,5158,03/04/2017,DEB,Amazon UK Marketpl,9.99,,18081.69,Amazon,Swansea,Uk
5158,5159,03/04/2017,DEB,AMAZON UK RETAIL A,35.9,,18091.68,Amazon,Swansea,Uk
5159,5160,03/04/2017,DD,NATWEST BANK,828.49,,18127.58,Mortgage,Swansea,Uk
5160,5161,03/04/2017,DD,CC SWANSEA C.TAX,177.49,,18956.07,Bills,Swansea,Uk
5161,5162,03/04/2017,DD,GOOD ENERGY LTD,85.0,,19133.56,Bills,Swansea,Uk
5162,5163,03/04/2017,DD,ASSURANT INTER LTD,39.74,,19218.56,Insurance,Swansea,Uk
5163,5164,03/04/2017,DD,DWR CYMRU W WATER,32.5,,19258.3,Bills,Swansea,Uk
5164,5165,03/04/2017,DD,TV LICENCE MBP,12.12,,19290.8,Bills,Swansea,Uk
5165,5166,03/04/2017,SO,ESAVINGS ACCOUNT,300.0,,19302.92,Savings,Swansea,Uk
5166,5167,31/03/2017,DEB,NON-STG CASH FEE,2.0,,19602.92,Others,Swansea,Uk
5167,5168,31/03/2017,DEB,NON-STG TRANS FEE,2.47,,19604.92,Others,Swansea,Uk
5168,5169,31/03/2017,DEB,TETOUAN MHANNEC,82.74,,19607.39,Services,Swansea,Uk
5169,5170,31/03/2017,DD,UCU B ACCOUNT,22.7,,19690.13,Others,Swansea,Uk
5170,5171,31/03/2017,DEB,NON-STG CASH FEE,2.0,,19712.83,Others,Swansea,Uk
5171,5172,31/03/2017,DEB,NON-STG TRANS FEE,2.47,,19714.83,Others,Swansea,Uk
5172,5173,31/03/2017,DEB,CASA AEREPORT M,82.69,,19717.3,Travel,Casablanca,Morocco
5173,5174,31/03/2017,BP,SAVE THE CHANGE,0.03,,19799.99,Savings,Swansea,Uk
5174,5175,31/03/2017,BGC,SWANSEA UNI - PAY,,3112.59,19800.02,Paycheck,Swansea,Uk
5175,5176,30/03/2017,DEB,Amazon UK Marketpl,1.97,,16687.43,Amazon,Swansea,Uk
5176,5177,28/03/2017,BP,SAVE THE CHANGE,0.01,,16689.4,Savings,Swansea,Uk
5177,5178,27/03/2017,DEB,Amazon UK Marketpl,26.99,,16689.41,Amazon,Swansea,Uk
5178,5179,27/03/2017,DEB,Amazon UK Marketpl,6.0,,16716.4,Amazon,Swansea,Uk
5179,5180,27/03/2017,BP,SAVE THE CHANGE,0.68,,16722.4,Savings,Swansea,Uk
5180,5181,24/03/2017,DEB,Amazon UK Retail,9.9,,16723.08,Amazon,Swansea,Uk
5181,5182,24/03/2017,DEB,AMAZON UK RETAIL A,9.42,,16732.98,Amazon,Swansea,Uk
5182,5183,24/03/2017,BP,SAVE THE CHANGE,0.3,,16742.4,Savings,Swansea,Uk
5183,5184,23/03/2017,CPT,LOYD TALIESIN BUIL,100.0,,16742.7,Cash,,
5184,5185,23/03/2017,DEB,AMAZON UK RETAIL A,35.7,,16842.7,Amazon,Swansea,Uk
5185,5186,23/03/2017,BP,SAVE THE CHANGE,0.21,,16878.4,Savings,Swansea,Uk
5186,5187,22/03/2017,DEB,Amazon UK Retail,4.79,,16878.61,Amazon,Swansea,Uk
5187,5188,22/03/2017,CPT,LNK UNI - UNIVERSI,100.0,,16883.4,Cash,Swansea,Uk
5188,5189,22/03/2017,DD,CORGI HOMEPLAN CA,19.5,,16983.4,Home Improvement,Swansea,Uk
5189,5190,21/03/2017,CPT,LNK UNI - UNIVERSI,50.0,,17002.9,Cash,Swansea,Uk
5190,5191,21/03/2017,DD,VIRGIN MEDIA PYMTS,31.48,,17052.9,Bills,Nottingham,Uk
5191,5192,21/03/2017,BP,SAVE THE CHANGE,1.84,,17084.38,Savings,Swansea,Uk
5192,5193,20/03/2017,DEB,AMAZON UK RETAIL A,93.73,,17086.22,Amazon,Swansea,Uk
5193,5194,20/03/2017,DEB,IKEA ONLINE,82.5,,17179.95,Other Shopping,,
5194,5195,20/03/2017,DEB,Amazon UK Retail,8.97,,17262.45,Amazon,Swansea,Uk
5195,5196,20/03/2017,DEB,GWR WEBSALES,112.7,,17271.42,Travel,,
5196,5197,20/03/2017,DEB,Amazon UK Marketpl,5.26,,17384.12,Amazon,Swansea,Uk
5197,5198,17/03/2017,DEB,AMZ*MokenEye-UK,,35.99,17389.38,Supplementary Income,Swansea,Uk
5198,5199,17/03/2017,CPT,LNK UNI - UNIVERSI,30.0,,17353.39,Cash,Swansea,Uk
5199,5200,17/03/2017,BP,SAVE THE CHANGE,0.75,,17383.39,Savings,Swansea,Uk
5200,5201,16/03/2017,DEB,AMAZON.CO.UK,7.25,,17384.14,Amazon,Swansea,Uk
5201,5202,16/03/2017,CPT,LNK UNI - UNIVERSI,50.0,,17391.39,Cash,Swansea,Uk
5202,5203,16/03/2017,DD,O2,16.83,,17441.39,Other Shopping,Swansea,Uk
5203,5204,16/03/2017,BP,SAVE THE CHANGE,0.54,,17458.22,Savings,Swansea,Uk
5204,5205,15/03/2017,DEB,Amazon UK Marketpl,3.46,,17458.76,Amazon,Swansea,Uk
5205,5206,15/03/2017,BP,SAVE THE CHANGE,1.94,,17462.22,Savings,Swansea,Uk
5206,5207,14/03/2017,DEB,Amazon UK Marketpl,12.86,,17464.16,Amazon,Swansea,Uk
5207,5208,14/03/2017,DEB,Amazon UK Marketpl,10.05,,17477.02,Amazon,Swansea,Uk
5208,5209,14/03/2017,DEB,NON-STG PURCH FEE,1.0,,17487.07,Others,Swansea,Uk
5209,5210,14/03/2017,DEB,NON-STG TRANS FEE,8.67,,17488.07,Others,Swansea,Uk
5210,5211,14/03/2017,DEB,AIRMARO G.B I,290.15,,17496.74,Travel,,
5211,5212,14/03/2017,BP,SAVE THE CHANGE,0.6,,17786.89,Savings,Swansea,Uk
5212,5213,13/03/2017,DEB,ARRIVA TRAINS WALE,22.4,,17787.49,Travel,,
5213,5214,13/03/2017,CPT,LNK ARRIVA TRAINS,80.0,,17809.89,Cash,,
5214,5215,10/03/2017,DEB,AMAZON UK PRIME AM,79.0,,17889.89,Amazon,Swansea,Uk
5215,5216,10/03/2017,CPT,LNK UNI - UNIVERSI,60.0,,17968.89,Cash,Swansea,Uk
5216,5217,10/03/2017,BP,SAVE THE CHANGE,0.97,,18028.89,Savings,Swansea,Uk
5217,5218,09/03/2017,DEB,Amazon UK Marketpl,20.03,,18029.86,Amazon,Swansea,Uk
5218,5219,09/03/2017,BP,SAVE THE CHANGE,0.17,,18049.89,Savings,Swansea,Uk
5219,5220,08/03/2017,DEB,AMAZON UK RETAIL A,5.83,,18050.06,Amazon,Swansea,Uk
5220,5221,08/03/2017,CPT,LNK UNI - UNIVERSI,30.0,,18055.89,Cash,Swansea,Uk
5221,5222,08/03/2017,DD,LV LIFE,37.12,,18085.89,Insurance,Swansea,Uk
5222,5223,07/03/2017,BP,SAVE THE CHANGE,2.05,,18123.01,Savings,Swansea,Uk
5223,5224,06/03/2017,DEB,Amazon UK Marketpl,35.99,,18125.06,Amazon,Swansea,Uk
5224,5225,06/03/2017,DEB,ARRIVA TRAINS WALE,95.3,,18161.05,Travel,,
5225,5226,06/03/2017,DEB,ASHA'S,42.2,,18256.35,Dine Out,,
5226,5227,06/03/2017,DEB,Amazon UK Marketpl,10.88,,18298.55,Amazon,Swansea,Uk
5227,5228,06/03/2017,DEB,WASABI BIRMINGHAM,10.58,,18309.43,Dine Out,Birmingham,Uk
5228,5229,06/03/2017,CPT,LNK UNI - UNIVERSI,50.0,,18320.01,Cash,Swansea,Uk
5229,5230,06/03/2017,BP,SAVE THE CHANGE,0.75,,18370.01,Savings,Swansea,Uk
5230,5231,03/03/2017,DEB,Amazon UK Marketpl,20.79,,18370.76,Amazon,Swansea,Uk
5231,5232,03/03/2017,DEB,Amazon UK Marketpl,5.46,,18391.55,Amazon,Swansea,Uk
5232,5233,03/03/2017,DD,ASSURANT INTER LTD,39.74,,18397.01,Savings,Swansea,Uk
5233,5234,02/03/2017,CPT,LNK UNI - UNIVERSI,50.0,,18436.75,Cash,Swansea,Uk
5234,5235,02/03/2017,BP,SAVE THE CHANGE,0.63,,18486.75,Savings,Swansea,Uk
5235,5236,01/03/2017,FEE,ACCOUNT FEE,9.95,,18487.38,Bills,Swansea,Uk
5236,5237,01/03/2017,DEB,Amazon UK Marketpl,8.38,,18497.33,Amazon,Swansea,Uk
5237,5238,01/03/2017,DEB,AMAZON UK RETAIL A,3.99,,18505.71,Amazon,Swansea,Uk
5238,5239,01/03/2017,DD,NATWEST BANK,828.49,,18509.7,Mortgage,Swansea,Uk
5239,5240,01/03/2017,DD,GOOD ENERGY LTD,85.0,,19338.19,Bills,Swansea,Uk
5240,5241,01/03/2017,DD,DWR CYMRU W WATER,32.5,,19423.19,Bills,Swansea,Uk
5241,5242,01/03/2017,DD,TV LICENCE MBP,12.12,,19455.69,Bills,Swansea,Uk
5242,5243,01/03/2017,SO,ESAVINGS ACCOUNT,300.0,,19467.81,Savings,Swansea,Uk
5243,5244,28/02/2017,CPT,LNK UNI - UNIVERSI,50.0,,19767.81,Cash,Swansea,Uk
5244,5245,28/02/2017,DD,UCU B ACCOUNT,22.7,,19817.81,Others,Swansea,Uk
5245,5246,28/02/2017,BP,SAVE THE CHANGE,0.98,,19840.51,Savings,Swansea,Uk
5246,5247,28/02/2017,BGC,SWANSEA UNI - PAY,,3112.59,19841.49,Paycheck,Swansea,Uk
5247,5248,27/02/2017,DEB,AMAZON UK RETAIL A,26.02,,16728.9,Amazon,Swansea,Uk
5248,5249,24/02/2017,CPT,LNK UNI - UNIVERSI,50.0,,16754.92,Cash,Swansea,Uk
5249,5250,23/02/2017,BP,SAVE THE CHANGE,0.54,,16804.92,Savings,Swansea,Uk
5250,5251,22/02/2017,DEB,Amazon UK Marketpl,26.46,,16805.46,Amazon,Swansea,Uk
5251,5252,22/02/2017,DD,CORGI HOMEPLAN CA,19.5,,16831.92,Home Improvement,Swansea,Uk
5252,5253,22/02/2017,BP,SAVE THE CHANGE,0.38,,16851.42,Savings,Swansea,Uk
5253,5254,21/02/2017,DEB,Amazon UK Marketpl,3.63,,16851.8,Amazon,Swansea,Uk
5254,5255,21/02/2017,DEB,AMAZON UK RETAIL A,9.99,,16855.43,Amazon,Swansea,Uk
5255,5256,21/02/2017,CPT,LNK UNI - UNIVERSI,50.0,,16865.42,Cash,Swansea,Uk
5256,5257,21/02/2017,DD,VIRGIN MEDIA PYMTS,31.48,,16915.42,Bills,Nottingham,Uk
5257,5258,21/02/2017,BP,SAVE THE CHANGE,0.02,,16946.9,Savings,Swansea,Uk
5258,5259,20/02/2017,DEB,Amazon UK Marketpl,7.98,,16946.92,Amazon,Swansea,Uk
5259,5260,17/02/2017,CPT,LNK UNI - UNIVERSI,40.0,,16954.9,Cash,Swansea,Uk
5260,5261,17/02/2017,CHQ,51,156.0,,16994.9,Cash,,
5261,5262,17/02/2017,BP,SAVE THE CHANGE,0.94,,17150.9,Savings,Swansea,Uk
5262,5263,16/02/2017,DEB,Amazon UK Marketpl,7.82,,17151.84,Amazon,Swansea,Uk
5263,5264,16/02/2017,DEB,Amazon UK Marketpl,3.24,,17159.66,Amazon,Swansea,Uk
5264,5265,16/02/2017,DD,O2,16.83,,17162.9,Other Shopping,Swansea,Uk
5265,5266,15/02/2017,CPT,LNK UNI - UNIVERSI,40.0,,17179.73,Cash,Swansea,Uk
5266,5267,13/02/2017,CPT,LNK UNI - UNIVERSI,50.0,,17219.73,Cash,Swansea,Uk
5267,5268,13/02/2017,BP,SAVE THE CHANGE,1.35,,17269.73,Savings,Swansea,Uk
5268,5269,10/02/2017,DEB,WWW.ORGANICFRESHFO,122.58,,17271.08,Groceries,Swansea,Uk
5269,5270,10/02/2017,DEB,Amazon UK Marketpl,12.07,,17393.66,Amazon,Swansea,Uk
5270,5271,10/02/2017,CPT,LNK UNI - UNIVERSI,30.0,,17405.73,Cash,Swansea,Uk
5271,5272,10/02/2017,BP,SAVE THE CHANGE,0.45,,17435.73,Savings,Swansea,Uk
5272,5273,09/02/2017,DEB,Amazon UK Marketpl,8.55,,17436.18,Amazon,Swansea,Uk
5273,5274,08/02/2017,CPT,LNK UNI - UNIVERSI,40.0,,17444.73,Cash,Swansea,Uk
5274,5275,08/02/2017,DD,LV LIFE,37.12,,17484.73,Insurance,Swansea,Uk
5275,5276,07/02/2017,CPT,LNK UNI - UNIVERSI,50.0,,17521.85,Cash,Swansea,Uk
5276,5277,07/02/2017,BP,SAVE THE CHANGE,0.59,,17571.85,Savings,Swansea,Uk
5277,5278,06/02/2017,DEB,Amazon UK Marketpl,4.41,,17572.44,Amazon,Swansea,Uk
5278,5279,06/02/2017,DEB,Amazon UK Marketpl,6.0,,17576.85,Amazon,Swansea,Uk
5279,5280,03/02/2017,CPT,LNK UNI - UNIVERSI,30.0,,17582.85,Cash,Swansea,Uk
5280,5281,03/02/2017,DD,GOOD ENERGY LTD,85.0,,17612.85,Bills,Swansea,Uk
5281,5282,03/02/2017,DD,ASSURANT INTER LTD,39.74,,17697.85,Insurance,Swansea,Uk
5282,5283,03/02/2017,BP,SAVE THE CHANGE,0.49,,17737.59,Savings,Swansea,Uk
5283,5284,02/02/2017,DEB,Amazon UK Marketpl,17.99,,17738.08,Amazon,Swansea,Uk
5284,5285,02/02/2017,DEB,Amazon UK Marketpl,16.52,,17756.07,Amazon,Swansea,Uk
5285,5286,02/02/2017,CPT,LNK UNI - UNIVERSI,50.0,,17772.59,Cash,Swansea,Uk
5286,5287,01/02/2017,FEE,ACCOUNT FEE,9.95,,17822.59,Bills,Swansea,Uk
5287,5288,01/02/2017,DD,NATWEST BANK,828.49,,17832.54,Mortgage,Swansea,Uk
5288,5289,01/02/2017,DD,DWR CYMRU W WATER,32.5,,18661.03,Bills,Swansea,Uk
5289,5290,01/02/2017,DD,TV LICENCE MBP,12.12,,18693.53,Bills,Swansea,Uk
5290,5291,01/02/2017,SO,ESAVINGS ACCOUNT,300.0,,18705.65,Savings,Swansea,Uk
5291,5292,01/02/2017,BP,SAVE THE CHANGE,0.01,,19005.65,Savings,Swansea,Uk
5292,5293,31/01/2017,DEB,Amazon UK Marketpl,4.99,,19005.66,Amazon,Swansea,Uk
5293,5294,31/01/2017,CPT,LNK UNI - UNIVERSI,50.0,,19010.65,Cash,Swansea,Uk
5294,5295,31/01/2017,DD,UCU B ACCOUNT,22.7,,19060.65,Others,Swansea,Uk
5295,5296,31/01/2017,BP,SAVE THE CHANGE,0.73,,19083.35,Savings,Swansea,Uk
5296,5297,31/01/2017,BGC,SWANSEA UNI - PAY,,3113.0,19084.08,Paycheck,Swansea,Uk
5297,5298,30/01/2017,DEB,Amazon UK Marketpl,1.27,,15971.08,Amazon,Swansea,Uk
5298,5299,30/01/2017,BP,SAVE THE CHANGE,2.02,,15972.35,Savings,Swansea,Uk
5299,5300,27/01/2017,DEB,JS ONLINE GROCERY,210.85,,15974.37,Groceries,Swansea,Uk
5300,5301,27/01/2017,DEB,Amazon UK Marketpl,20.03,,16185.22,Amazon,Swansea,Uk
5301,5302,27/01/2017,DEB,Amazon UK Marketpl,5.4,,16205.25,Amazon,Swansea,Uk
5302,5303,27/01/2017,DEB,Amazon UK Retail,2.7,,16210.65,Amazon,Swansea,Uk
5303,5304,27/01/2017,CPT,LNK THE KINGSWAY,60.0,,16213.35,Cash,,
5304,5305,27/01/2017,BGC,SWANSEA UNIVERSITY,,168.35,16273.35,Supplementary Income,Swansea,Uk
5305,5306,25/01/2017,FPO,JOHN DEMISA,81.0,,16105.0,Services,Swansea,Uk
5306,5307,25/01/2017,CPT,LNK UNI - UNIVERSI,50.0,,16186.0,Cash,Swansea,Uk
5307,5308,25/01/2017,BP,SAVE THE CHANGE,0.05,,16236.0,Savings,Swansea,Uk
5308,5309,24/01/2017,DEB,TICKETS 0871220026,174.0,,16236.05,Travel,,
5309,5310,24/01/2017,DEB,Amazon UK Marketpl,15.95,,16410.05,Amazon,Swansea,Uk
5310,5311,24/01/2017,BP,SAVE THE CHANGE,0.73,,16426.0,Savings,Swansea,Uk
5311,5312,23/01/2017,DEB,ODEON,20.0,,16426.73,Entertainment,,
5312,5313,23/01/2017,DEB,Amazon UK Marketpl,1.27,,16446.73,Amazon,Swansea,Uk
5313,5314,23/01/2017,CPT,LNK UNI - UNIVERSI,60.0,,16448.0,Cash,Swansea,Uk
5314,5315,23/01/2017,DD,VIRGIN MEDIA PYMTS,31.48,,16508.0,Bills,Nottingham,Uk
5315,5316,23/01/2017,DD,CORGI HOMEPLAN CA,19.5,,16539.48,Home Improvement,Swansea,Uk
5316,5317,20/01/2017,CPT,LNK UNI - UNIVERSI,60.0,,16558.98,Cash,Swansea,Uk
5317,5318,17/01/2017,CPT,LNK UNI - UNIVERSI,60.0,,16618.98,Cash,Swansea,Uk
5318,5319,17/01/2017,BP,SAVE THE CHANGE,0.01,,16678.98,Savings,Swansea,Uk
5319,5320,16/01/2017,DEB,Amazon UK Marketpl,11.99,,16678.99,Amazon,Swansea,Uk
5320,5321,16/01/2017,DD,O2,18.82,,16690.98,Other Shopping,Swansea,Uk
5321,5322,13/01/2017,CPT,LNK UNI - UNIVERSI,50.0,,16709.8,Cash,Swansea,Uk
5322,5323,13/01/2017,BP,SAVE THE CHANGE,0.93,,16759.8,Savings,Swansea,Uk
5323,5324,12/01/2017,DEB,Amazon UK Marketpl,12.07,,16760.73,Amazon,Swansea,Uk
5324,5325,11/01/2017,BP,SAVE THE CHANGE,0.22,,16772.8,Savings,Swansea,Uk
5325,5326,10/01/2017,DEB,Amazon UK Marketpl,23.78,,16773.02,Amazon,Swansea,Uk
5326,5327,10/01/2017,CPT,LNK UNI - UNIVERSI,50.0,,16796.8,Cash,Swansea,Uk
5327,5328,09/01/2017,CPT,LNK UNI - UNIVERSI,30.0,,16846.8,Cash,Swansea,Uk
5328,5329,09/01/2017,DD,LV LIFE,37.12,,16876.8,Insurance,Swansea,Uk
5329,5330,06/01/2017,CPT,LNK UNI - UNIVERSI,50.0,,16913.92,Cash,Swansea,Uk
5330,5331,06/01/2017,BP,SAVE THE CHANGE,0.58,,16963.92,Savings,Swansea,Uk
5331,5332,05/01/2017,DEB,WWW.ORGANICFRESHFO,112.42,,16964.5,Groceries,Swansea,Uk
5332,5333,05/01/2017,DEB,AMAZON UK RETAIL A,12.0,,17076.92,Amazon,Swansea,Uk
5333,5334,05/01/2017,BP,SAVE THE CHANGE,0.69,,17088.92,Savings,Swansea,Uk
5334,5335,04/01/2017,DEB,Amazon UK Marketpl,10.58,,17089.61,Amazon,Swansea,Uk
5335,5336,04/01/2017,DEB,Amazon UK Marketpl,1.73,,17100.19,Amazon,Swansea,Uk
5336,5337,04/01/2017,BP,SAVE THE CHANGE,1.42,,17101.92,Savings,Swansea,Uk
5337,5338,03/01/2017,FEE,ACCOUNT FEE,9.95,,17103.34,Bills,Swansea,Uk
5338,5339,03/01/2017,DEB,VUE BSL LTD,24.48,,17113.29,Entertainment,,
5339,5340,03/01/2017,DEB,AMAZON UK RETAIL A,8.1,,17137.77,Amazon,Swansea,Uk
5340,5341,03/01/2017,DD,NATWEST BANK,828.49,,17145.87,Mortgage,Swansea,Uk
5341,5342,03/01/2017,DD,CC SWANSEA C.TAX,233.0,,17974.36,Bills,Swansea,Uk
5342,5343,03/01/2017,DD,GOOD ENERGY GAS,43.0,,18207.36,Bills,Swansea,Uk
5343,5344,03/01/2017,DD,GOOD ENERGY LTD,42.0,,18250.36,Bills,Swansea,Uk
5344,5345,03/01/2017,DD,ASSURANT INTER LTD,39.74,,18292.36,Insurance,Swansea,Uk
5345,5346,03/01/2017,DD,DWR CYMRU W WATER,32.5,,18332.1,Bills,Swansea,Uk
5346,5347,03/01/2017,DD,TV LICENCE MBP,12.12,,18364.6,Bills,Swansea,Uk
5347,5348,03/01/2017,SO,ESAVINGS ACCOUNT,300.0,,18376.72,Savings,Swansea,Uk
5348,5349,03/01/2017,CPT,LNK SWANSEA WIND S,50.0,,18676.72,Cash,Swansea,Uk
5349,5350,30/12/2016,DD,UCU B ACCOUNT,22.7,,18726.72,Others,Swansea,Uk
5350,5351,29/12/2016,BP,SAVE THE CHANGE,0.05,,18749.42,Savings,Swansea,Uk
5351,5352,28/12/2016,DEB,Amazon UK Marketpl,139.95,,18749.47,Amazon,Swansea,Uk
5352,5353,28/12/2016,FPI,MARIANA MILLS,,250.0,18889.42,Supplementary Income,Swansea,Uk
5353,5354,22/12/2016,DD,CORGI HOMEPLAN CA,19.5,,18639.42,Home Improvement,Swansea,Uk
5354,5355,22/12/2016,BP,SAVE THE CHANGE,0.4,,18658.92,Savings,Swansea,Uk
5355,5356,22/12/2016,BGC,SWANSEA UNIVERSITY,,1048.42,18659.32,Supplementary Income,Swansea,Uk
5356,5357,21/12/2016,DEB,ARRIVA TRAINS WALE,72.6,,17610.9,Travel,,
5357,5358,21/12/2016,DD,VIRGIN MEDIA PYMTS,31.48,,17683.5,Bills,Nottingham,Uk
5358,5359,21/12/2016,BP,SAVE THE CHANGE,1.18,,17714.98,Savings,Swansea,Uk
5359,5360,20/12/2016,DEB,POST OFFICE COUNTE,4.84,,17716.16,Others,Swansea,Uk
5360,5361,20/12/2016,DEB,Amazon UK Marketpl,4.29,,17721.0,Amazon,Swansea,Uk
5361,5362,20/12/2016,DEB,Amazon UK Marketpl,2.69,,17725.29,Amazon,Swansea,Uk
5362,5363,20/12/2016,BP,SAVE THE CHANGE,0.54,,17727.98,Savings,Swansea,Uk
5363,5364,19/12/2016,DEB,Amazon UK Marketpl,26.46,,17728.52,Amazon,Swansea,Uk
5364,5365,19/12/2016,CPT,LNK UNI - UNIVERSI,100.0,,17754.98,Cash,Swansea,Uk
5365,5366,19/12/2016,BP,SAVE THE CHANGE,0.28,,17854.98,Savings,Swansea,Uk
5366,5367,19/12/2016,BGC,SWANSEA UNI - PAY,,3112.59,17855.26,Paycheck,Swansea,Uk
5367,5368,16/12/2016,DEB,AMAZON UK RETAIL A,9.72,,14742.67,Amazon,Swansea,Uk
5368,5369,16/12/2016,CPT,LNK UNI - UNIVERSI,50.0,,14752.39,Cash,Swansea,Uk
5369,5370,16/12/2016,DD,O2,17.41,,14802.39,Other Shopping,Swansea,Uk
5370,5371,16/12/2016,BP,SAVE THE CHANGE,0.85,,14819.8,Savings,Swansea,Uk
5371,5372,15/12/2016,DEB,Amazon UK Marketpl,16.15,,14820.65,Amazon,Swansea,Uk
5372,5373,14/12/2016,BP,SAVE THE CHANGE,0.37,,14836.8,Savings,Swansea,Uk
5373,5374,13/12/2016,DEB,Amazon UK Marketpl,3.63,,14837.17,Amazon,Swansea,Uk
5374,5375,13/12/2016,FPI,MARIANA MILLS,,300.0,14840.8,Supplementary Income,Swansea,Uk
5375,5376,13/12/2016,CPT,LNK UNI - UNIVERSI,50.0,,14540.8,Cash,Swansea,Uk
5376,5377,13/12/2016,BP,SAVE THE CHANGE,0.87,,14590.8,Savings,Swansea,Uk
5377,5378,12/12/2016,DEB,Amazon UK Retail,13.79,,14591.67,Amazon,Swansea,Uk
5378,5379,12/12/2016,DEB,Amazon UK Marketpl,3.45,,14605.46,Amazon,Swansea,Uk
5379,5380,12/12/2016,DEB,AMAZON UK RETAIL A,9.99,,14608.91,Amazon,Swansea,Uk
5380,5381,12/12/2016,DEB,Amazon UK Retail,9.9,,14618.9,Amazon,Swansea,Uk
5381,5382,09/12/2016,CPT,LOYD TALIESIN BUIL,50.0,,14628.8,Cash,,
5382,5383,09/12/2016,DD,LV LIFE,37.12,,14678.8,Insurance,Swansea,Uk
5383,5384,09/12/2016,BP,SAVE THE CHANGE,0.97,,14715.92,Savings,Swansea,Uk
5384,5385,08/12/2016,DEB,Amazon UK Marketpl,20.03,,14716.89,Amazon,Swansea,Uk
5385,5386,08/12/2016,DEB,AMAZON UK RETAIL A,,7.0,14736.92,Supplementary Income,Swansea,Uk
5386,5387,07/12/2016,CPT,LNK UNI - UNIVERSI,40.0,,14729.92,Cash,Swansea,Uk
5387,5388,07/12/2016,BP,SAVE THE CHANGE,1.39,,14769.92,Savings,Swansea,Uk
5388,5389,06/12/2016,DEB,AMAZON UK RETAIL A,88.9,,14771.31,Amazon,Swansea,Uk
5389,5390,06/12/2016,DEB,AMAZON MKTPLACE PM,29.34,,14860.21,Amazon,Swansea,Uk
5390,5391,06/12/2016,DEB,AMAZON.DE PAYMENTS,16.56,,14889.55,Amazon,Swansea,Uk
5391,5392,06/12/2016,DEB,AMAZON MKTPLACE PM,7.81,,14906.11,Amazon,Swansea,Uk
5392,5393,06/12/2016,CPT,LNK UNI - UNIVERSI,40.0,,14913.92,Cash,Swansea,Uk
5393,5394,05/12/2016,DD,ASSURANT INTER LTD,39.74,,14953.92,Insurance,Swansea,Uk
5394,5395,05/12/2016,BP,SAVE THE CHANGE,0.56,,14993.66,Savings,Swansea,Uk
5395,5396,02/12/2016,DEB,Amazon *Mktplce EU,96.95,,14994.22,Amazon,Swansea,Uk
5396,5397,02/12/2016,DEB,Amazon UK Marketpl,18.49,,15091.17,Amazon,Swansea,Uk
5397,5398,02/12/2016,CPT,LNK UNI - UNIVERSI,50.0,,15109.66,Cash,Swansea,Uk
5398,5399,01/12/2016,FEE,ACCOUNT FEE,9.95,,15159.66,Bills,Swansea,Uk
5399,5400,01/12/2016,DD,NATWEST BANK,828.49,,15169.61,Mortgage,Swansea,Uk
5400,5401,01/12/2016,DD,CC SWANSEA C.TAX,233.0,,15998.1,Bills,Swansea,Uk
5401,5402,01/12/2016,DD,GOOD ENERGY GAS,43.0,,16231.1,Bills,Swansea,Uk
5402,5403,01/12/2016,DD,GOOD ENERGY LTD,42.0,,16274.1,Bills,Swansea,Uk
5403,5404,01/12/2016,DD,DWR CYMRU W WATER,32.5,,16316.1,Bills,Swansea,Uk
5404,5405,01/12/2016,DD,TV LICENCE MBP,12.18,,16348.6,Bills,Swansea,Uk
5405,5406,01/12/2016,SO,ESAVINGS ACCOUNT,300.0,,16360.78,Savings,Swansea,Uk
5406,5407,01/12/2016,BP,SAVE THE CHANGE,0.6,,16660.78,Savings,Swansea,Uk
5407,5408,30/11/2016,DEB,ARRIVA TRAINS WALE,56.4,,16661.38,Travel,,
5408,5409,30/11/2016,DD,UCU B ACCOUNT,22.7,,16717.78,Others,Swansea,Uk
5409,5410,30/11/2016,BP,SAVE THE CHANGE,0.6,,16740.48,Savings,Swansea,Uk
5410,5411,30/11/2016,BGC,SWANSEA UNI - PAY,,3112.59,16741.08,Paycheck,Swansea,Uk
5411,5412,29/11/2016,CPT,LNK ARRIVA TRAINS,80.0,,13628.49,Cash,,
5412,5413,29/11/2016,DEB,ARRIVA TRAINS WALE,56.4,,13708.49,Travel,,
5413,5414,29/11/2016,BP,SAVE THE CHANGE,0.1,,13764.89,Savings,Swansea,Uk
5414,5415,28/11/2016,DEB,Amazon UK Marketpl,12.9,,13764.99,Amazon,Swansea,Uk
5415,5416,28/11/2016,CPT,LNK ARRIVA TRAINS,80.0,,13777.89,Cash,,
5416,5417,28/11/2016,BP,SAVE THE CHANGE,0.35,,13857.89,Savings,Swansea,Uk
5417,5418,28/11/2016,FPI,MARIANA MILLS,,25.0,13858.24,Supplementary Income,Swansea,Uk
5418,5419,25/11/2016,DEB,JS ONLINE GROCERY,322.65,,13833.24,Groceries,Swansea,Uk
5419,5420,25/11/2016,CPT,LNK UNI - UNIVERSI,50.0,,14155.89,Cash,Swansea,Uk
5420,5421,24/11/2016,BP,SAVE THE CHANGE,0.02,,14205.89,Savings,Swansea,Uk
5421,5422,23/11/2016,DEB,Amazon UK Marketpl,39.99,,14205.91,Amazon,Swansea,Uk
5422,5423,23/11/2016,DEB,AMAZON UK RETAIL A,10.99,,14245.9,Amazon,Swansea,Uk
5423,5424,23/11/2016,CPT,LNK UNI - UNIVERSI,50.0,,14256.89,Cash,Swansea,Uk
5424,5425,23/11/2016,BP,SAVE THE CHANGE,1.58,,14306.89,Savings,Swansea,Uk
5425,5426,22/11/2016,DEB,Amazon UK Marketpl,408.45,,14308.47,Amazon,Swansea,Uk
5426,5427,22/11/2016,DEB,Amazon UK Marketpl,9.49,,14716.92,Amazon,Swansea,Uk
5427,5428,22/11/2016,DEB,SUSU TRADING LTD,54.48,,14726.41,Home Improvement,Swansea,Uk
5428,5429,22/11/2016,DD,CORGI HOMEPLAN CA,19.5,,14780.89,Home Improvement,Swansea,Uk
5429,5430,22/11/2016,BP,SAVE THE CHANGE,0.86,,14800.39,Savings,Swansea,Uk
5430,5431,21/11/2016,DEB,Amazon UK Marketpl,42.98,,14801.25,Amazon,Swansea,Uk
5431,5432,21/11/2016,DEB,Amazon UK Marketpl,23.99,,14844.23,Amazon,Swansea,Uk
5432,5433,21/11/2016,DEB,Amazon UK Marketpl,8.17,,14868.22,Amazon,Swansea,Uk
5433,5434,21/11/2016,CPT,LNK UNI - UNIVERSI,50.0,,14876.39,Cash,Swansea,Uk
5434,5435,21/11/2016,DD,VIRGIN MEDIA PYMTS,31.48,,14926.39,Bills,Nottingham,Uk
5435,5436,21/11/2016,BP,SAVE THE CHANGE,0.05,,14957.87,Savings,Swansea,Uk
5436,5437,18/11/2016,DEB,Amazon UK Marketpl,10.95,,14957.92,Amazon,Swansea,Uk
5437,5438,16/11/2016,DD,O2,37.28,,14968.87,Other Shopping,Swansea,Uk
5438,5439,16/11/2016,BP,SAVE THE CHANGE,1.52,,15006.15,Savings,Swansea,Uk
5439,5440,15/11/2016,DEB,Amazon UK Marketpl,12.49,,15007.67,Amazon,Swansea,Uk
5440,5441,15/11/2016,DEB,Amazon Svcs Europe,8.5,,15020.16,Amazon,Swansea,Uk
5441,5442,15/11/2016,DEB,Amazon UK Marketpl,8.49,,15028.66,Amazon,Swansea,Uk
5442,5443,15/11/2016,CPT,LNK UNI - UNIVERSI,50.0,,15037.15,Cash,Swansea,Uk
5443,5444,15/11/2016,BP,SAVE THE CHANGE,0.01,,15087.15,Savings,Swansea,Uk
5444,5445,14/11/2016,DEB,WWW.ALLBAMBOOLTD.C,102.0,,15087.16,Home Improvement,Swansea,Uk
5445,5446,14/11/2016,DEB,Amazon UK Retail,5.99,,15189.16,Amazon,Swansea,Uk
5446,5447,14/11/2016,FPI,MARIANA MILLS 13NOV16,,130.0,15195.15,Supplementary Income,Swansea,Uk
5447,5448,11/11/2016,CPT,LOYD TALIESIN BUIL,50.0,,15065.15,Cash,,
5448,5449,11/11/2016,CHQ,47,320.0,,15115.15,Cash,,
5449,5450,09/11/2016,DD,LV LIFE,37.12,,15435.15,Insurance,Swansea,Uk
5450,5451,09/11/2016,BP,SAVE THE CHANGE,1.04,,15472.27,Savings,Swansea,Uk
5451,5452,08/11/2016,DEB,Amazon UK Retail,11.45,,15473.31,Amazon,Swansea,Uk
5452,5453,08/11/2016,DEB,AMAZON MKTPLACE PM,6.51,,15484.76,Amazon,Swansea,Uk
5453,5454,08/11/2016,CPT,LNK FULTON HOUSE,50.0,,15491.27,Cash,Swansea,Uk
5454,5455,08/11/2016,BP,SAVE THE CHANGE,0.96,,15541.27,Savings,Swansea,Uk
5455,5456,07/11/2016,DEB,Amazon Svcs Europe,14.04,,15542.23,Amazon,Swansea,Uk
5456,5457,07/11/2016,BP,SAVE THE CHANGE,0.8,,15556.27,Savings,Swansea,Uk
5457,5458,04/11/2016,DEB,SWANSEA UNI - CATE,4.2,,15557.07,Dine Out,Swansea,Uk
5458,5459,04/11/2016,CPT,LOYD WALES UNIV SW,20.0,,15561.27,Cash,Swansea,Uk
5459,5460,03/11/2016,CPT,LOYD WALES UNIV SW,50.0,,15581.27,Cash,Swansea,Uk
5460,5461,03/11/2016,DD,ASSURANT INTER LTD,39.74,,15631.27,Insurance,Swansea,Uk
5461,5462,03/11/2016,BP,SAVE THE CHANGE,0.44,,15671.01,Savings,Swansea,Uk
5462,5463,02/11/2016,DEB,Amazon UK Marketpl,27.56,,15671.45,Amazon,Swansea,Uk
5463,5464,02/11/2016,BP,SAVE THE CHANGE,0.78,,15699.01,Savings,Swansea,Uk
5464,5465,01/11/2016,FEE,ACCOUNT FEE,9.95,,15699.79,Bills,Swansea,Uk
5465,5466,01/11/2016,FPI,MARIANA MILLS,,250.0,15709.74,Supplementary Income,Swansea,Uk
5466,5467,01/11/2016,DD,NATWEST BANK,828.49,,15459.74,Mortgage,Swansea,Uk
5467,5468,01/11/2016,DD,CC SWANSEA C.TAX,233.0,,16288.23,Bills,Swansea,Uk
5468,5469,01/11/2016,DD,GOOD ENERGY GAS,43.0,,16521.23,Bills,Swansea,Uk
5469,5470,01/11/2016,DD,GOOD ENERGY LTD,42.0,,16564.23,Bills,Swansea,Uk
5470,5471,01/11/2016,DD,DWR CYMRU W WATER,32.5,,16606.23,Bills,Swansea,Uk
5471,5472,01/11/2016,DD,TV LICENCE MBP,12.12,,16638.73,Bills,Swansea,Uk
5472,5473,01/11/2016,DEB,NON-STG PURCH FEE,1.0,,16650.85,Others,Swansea,Uk
5473,5474,01/11/2016,DEB,NON-STG TRANS FEE,24.49,,16651.85,Others,Swansea,Uk
5474,5475,01/11/2016,DEB,EMBASSY SUITES BAL,819.22,,16676.34,Travel,Baltimore,Usa
5475,5476,01/11/2016,SO,ESAVINGS ACCOUNT,300.0,,17495.56,Savings,Swansea,Uk
5476,5477,31/10/2016,CPT,LOYD WALES UNIV SW,50.0,,17795.56,Cash,Swansea,Uk
5477,5478,31/10/2016,DD,UCU B ACCOUNT,22.7,,17845.56,Others,Swansea,Uk
5478,5479,31/10/2016,BGC,SWANSEA UNI - PAY,,3166.96,17868.26,Paycheck,Swansea,Uk
5479,5480,28/10/2016,BP,SAVE THE CHANGE,0.06,,14701.3,Savings,Swansea,Uk
5480,5481,28/10/2016,BGC,SWANSEA UNIVERSITY,,438.85,14701.36,Supplementary Income,Swansea,Uk
5481,5482,27/10/2016,DEB,NON-STG PURCH FEE,1.0,,14262.51,Others,Swansea,Uk
5482,5483,27/10/2016,DEB,NON-STG TRANS FEE,2.45,,14263.51,Others,Swansea,Uk
5483,5484,27/10/2016,DEB,SUPREME AIRPORT SH,81.94,,14265.96,Travel,,
5484,5485,25/10/2016,BP,SAVE THE CHANGE,0.43,,14347.9,Savings,Swansea,Uk
5485,5486,24/10/2016,DEB,Amazon UK Marketpl,13.57,,14348.33,Amazon,Swansea,Uk
5486,5487,24/10/2016,DD,CORGI HOMEPLAN CA,19.5,,14361.9,Home Improvement,Swansea,Uk
5487,5488,24/10/2016,BP,SAVE THE CHANGE,0.04,,14381.4,Savings,Swansea,Uk
5488,5489,24/10/2016,BGC,SWANSEA UNIVERSITY,,335.33,14381.44,Supplementary Income,Swansea,Uk
5489,5490,21/10/2016,DEB,EASYJET   ERB813,645.96,,14046.11,Travel,,
5490,5491,21/10/2016,CPT,LOYD WALES UNIV SW,70.0,,14692.07,Cash,Swansea,Uk
5491,5492,21/10/2016,DD,VIRGIN MEDIA PYMTS,27.99,,14762.07,Bills,Nottingham,Uk
5492,5493,21/10/2016,BP,SAVE THE CHANGE,0.02,,14790.06,Savings,Swansea,Uk
5493,5494,20/10/2016,FPI,MARIANA MILLS,,340.0,14790.08,Supplementary Income,Swansea,Uk
5494,5495,20/10/2016,DEB,Amazon UK Marketpl,10.98,,14450.08,Amazon,Swansea,Uk
5495,5496,20/10/2016,CPT,LOYD WALES UNIV SW,80.0,,14461.06,Cash,Swansea,Uk
5496,5497,20/10/2016,BP,SAVE THE CHANGE,0.94,,14541.06,Savings,Swansea,Uk
5497,5498,19/10/2016,DEB,SUSU TRADING LTD,52.84,,14542.0,Home Improvement,Swansea,Uk
5498,5499,19/10/2016,DEB,Amazon *Mktplce EU,11.22,,14594.84,Cash,Swansea,Uk
5499,5500,18/10/2016,BP,SAVE THE CHANGE,0.97,,14606.06,Savings,Swansea,Uk
5500,5501,17/10/2016,DEB,Amazon UK Retail,30.43,,14607.03,Amazon,Swansea,Uk
5501,5502,17/10/2016,DEB,Audible.co.uk,14.6,,14637.46,Entertainment,,
5502,5503,17/10/2016,DEB,EC GIFTWARE LTD,,6.65,14652.06,Supplementary Income,Swansea,Uk
5503,5504,17/10/2016,DD,O2,33.12,,14645.41,Other Shopping,Swansea,Uk
5504,5505,17/10/2016,BP,SAVE THE CHANGE,1.99,,14678.53,Savings,Swansea,Uk
5505,5506,14/10/2016,DEB,Amazon UK Marketpl,14.01,,14680.52,Amazon,Swansea,Uk
5506,5507,14/10/2016,DEB,Amazon UK Marketpl,11.49,,14694.53,Amazon,Swansea,Uk
5507,5508,14/10/2016,DEB,EC GIFTWARE LTD,72.51,,14706.02,Other Shopping,,
5508,5509,14/10/2016,CPT,LOYD WALES UNIV SW,40.0,,14778.53,Cash,Swansea,Uk
5509,5510,11/10/2016,BP,SAVE THE CHANGE,1.07,,14818.53,Savings,Swansea,Uk
5510,5511,10/10/2016,DEB,Amazon UK Marketpl,22.99,,14819.6,Amazon,Swansea,Uk
5511,5512,10/10/2016,DEB,Amazon UK Marketpl,29.44,,14842.59,Amazon,Swansea,Uk
5512,5513,10/10/2016,DEB,Amazon UK Marketpl,8.5,,14872.03,Amazon,Swansea,Uk
5513,5514,10/10/2016,CPT,LOYD WALES UNIV SW,30.0,,14880.53,Cash,Swansea,Uk
5514,5515,10/10/2016,DD,LV LIFE,37.12,,14910.53,Insurance,Swansea,Uk
5515,5516,10/10/2016,BP,SAVE THE CHANGE,1.05,,14947.65,Savings,Swansea,Uk
5516,5517,07/10/2016,DEB,AMAZON UK RETAIL A,10.19,,14948.7,Amazon,Swansea,Uk
5517,5518,07/10/2016,DEB,Amazon Svcs Europe,8.76,,14958.89,Amazon,Swansea,Uk
5518,5519,07/10/2016,CPT,LOYD WALES UNIV SW,20.0,,14967.65,Cash,Swansea,Uk
5519,5520,07/10/2016,CHQ,46,40.0,,14987.65,Cash,,
5520,5521,06/10/2016,FPI,MARIANA MILLS,,250.0,15027.65,Supplementary Income,Swansea,Uk
5521,5522,06/10/2016,CPT,LOYD WALES UNIV SW,40.0,,14777.65,Cash,Swansea,Uk
5522,5523,05/10/2016,BP,SAVE THE CHANGE,0.83,,14817.65,Savings,Swansea,Uk
5523,5524,04/10/2016,DEB,Amazon UK Marketpl,9.98,,14818.48,Amazon,Swansea,Uk
5524,5525,04/10/2016,DEB,Amazon UK Marketpl,9.94,,14828.46,Amazon,Swansea,Uk
5525,5526,04/10/2016,DEB,Amazon UK Marketpl,4.25,,14838.4,Amazon,Swansea,Uk
5526,5527,04/10/2016,BP,SAVE THE CHANGE,0.47,,14842.65,Savings,Swansea,Uk
5527,5528,03/10/2016,FEE,ACCOUNT FEE,9.95,,14843.12,Bills,Swansea,Uk
5528,5529,03/10/2016,DEB,Amazon UK Marketpl,38.53,,14853.07,Amazon,Swansea,Uk
5529,5530,03/10/2016,DEB,Amazon UK Marketpl,165.0,,14891.6,Amazon,Swansea,Uk
5530,5531,03/10/2016,DD,NATWEST BANK,828.49,,15056.6,Mortgage,Swansea,Uk
5531,5532,03/10/2016,DD,CC SWANSEA C.TAX,231.81,,15885.09,Bills,Swansea,Uk
5532,5533,03/10/2016,DD,GOOD ENERGY GAS,43.0,,16116.9,Bills,Swansea,Uk
5533,5534,03/10/2016,DD,GOOD ENERGY LTD,42.0,,16159.9,Bills,Swansea,Uk
5534,5535,03/10/2016,DD,ASSURANT INTER LTD,39.74,,16201.9,Insurance,Swansea,Uk
5535,5536,03/10/2016,DD,DWR CYMRU W WATER,29.5,,16241.64,Bills,Swansea,Uk
5536,5537,03/10/2016,DD,TV LICENCE MBP,12.12,,16271.14,Bills,Swansea,Uk
5537,5538,03/10/2016,SO,ESAVINGS ACCOUNT,300.0,,16283.26,Savings,Swansea,Uk
5538,5539,03/10/2016,BP,SAVE THE CHANGE,0.85,,16583.26,Savings,Swansea,Uk
5539,5540,30/09/2016,DEB,JS ONLINE GROCERY,194.15,,16584.11,Groceries,Swansea,Uk
5540,5541,30/09/2016,DEB,JS ONLINE GROCERY,,3.0,16778.26,Supplementary Income,Swansea,Uk
5541,5542,30/09/2016,CPT,LOYD WALES UNIV SW,30.0,,16775.26,Cash,Swansea,Uk
5542,5543,30/09/2016,DD,UCU B ACCOUNT,22.7,,16805.26,Others,Swansea,Uk
5543,5544,30/09/2016,BGC,SWANSEA UNI - PAY,,3085.63,16827.96,Paycheck,Swansea,Uk
5544,5545,29/09/2016,BP,SAVE THE CHANGE,1.69,,13742.33,Savings,Swansea,Uk
5545,5546,28/09/2016,DEB,Amazon UK Marketpl,22.99,,13744.02,Amazon,Swansea,Uk
5546,5547,28/09/2016,DEB,PIZZA EXPRESS,20.3,,13767.01,Dine Out,,
5547,5548,28/09/2016,DEB,Amazon Svcs Europe,7.02,,13787.31,Amazon,Swansea,Uk
5548,5549,28/09/2016,CPT,LOYD WALES UNIV SW,50.0,,13794.33,Cash,Swansea,Uk
5549,5550,28/09/2016,BP,SAVE THE CHANGE,1.39,,13844.33,Savings,Swansea,Uk
5550,5551,27/09/2016,DEB,HILTON,265.0,,13845.72,Hotels,,
5551,5552,27/09/2016,DEB,ARRIVA TRAINS WALE,116.8,,14110.72,Travel,,
5552,5553,27/09/2016,DEB,ARRIVA TRAINS WALE,113.8,,14227.52,Travel,,
5553,5554,27/09/2016,DEB,Amazon UK Marketpl,13.54,,14341.32,Amazon,Swansea,Uk
5554,5555,27/09/2016,DEB,SKR*ETHICAL PETS,28.47,,14354.86,Other Shopping,,
5555,5556,27/09/2016,DEB,ARRIVA TRAINS WALE,,113.8,14383.33,Supplementary Income,Swansea,Uk
5556,5557,27/09/2016,BP,SAVE THE CHANGE,1.14,,14269.53,Savings,Swansea,Uk
5557,5558,26/09/2016,DEB,Amazon UK Retail,10.74,,14270.67,Amazon,Swansea,Uk
5558,5559,26/09/2016,DEB,Amazon UK Marketpl,1.83,,14281.41,Amazon,Swansea,Uk
5559,5560,26/09/2016,DEB,Amazon UK Marketpl,12.29,,14283.24,Amazon,Swansea,Uk
5560,5561,26/09/2016,CPT,LNK ARRIVA TRAINS,50.0,,14295.53,Cash,,
5561,5562,23/09/2016,BP,SAVE THE CHANGE,0.53,,14345.53,Savings,Swansea,Uk
5562,5563,22/09/2016,DEB,AMAZON UK RETAIL A,159.98,,14346.06,Amazon,Swansea,Uk
5563,5564,22/09/2016,DEB,AMAZON UK RETAIL A,19.49,,14506.04,Amazon,Swansea,Uk
5564,5565,22/09/2016,DD,CORGI HOMEPLAN CA,19.5,,14525.53,Home Improvement,Swansea,Uk
5565,5566,22/09/2016,BP,SAVE THE CHANGE,0.04,,14545.03,Savings,Swansea,Uk
5566,5567,21/09/2016,DEB,AMAZON UK RETAIL A,129.96,,14545.07,Amazon,Swansea,Uk
5567,5568,21/09/2016,DD,VIRGIN MEDIA PYMTS,27.99,,14675.03,Bills,Nottingham,Uk
5568,5569,21/09/2016,BP,SAVE THE CHANGE,0.05,,14703.02,Savings,Swansea,Uk
5569,5570,20/09/2016,DEB,Amazon UK Marketpl,16.99,,14703.07,Amazon,Swansea,Uk
5570,5571,20/09/2016,DEB,Amazon UK Marketpl,14.96,,14720.06,Amazon,Swansea,Uk
5571,5572,16/09/2016,DD,O2,24.21,,14735.02,Other Shopping,Swansea,Uk
5572,5573,14/09/2016,BP,SAVE THE CHANGE,0.05,,14759.23,Savings,Swansea,Uk
5573,5574,13/09/2016,DEB,Amazon UK Marketpl,36.95,,14759.28,Amazon,Swansea,Uk
5574,5575,13/09/2016,BP,SAVE THE CHANGE,0.28,,14796.23,Savings,Swansea,Uk
5575,5576,12/09/2016,DEB,Amazon UK Marketpl,9.72,,14796.51,Amazon,Swansea,Uk
5576,5577,12/09/2016,BP,SAVE THE CHANGE,0.42,,14806.23,Savings,Swansea,Uk
5577,5578,12/09/2016,FPI,MARIANA MILLS,,150.0,14806.65,Supplementary Income,Swansea,Uk
5578,5579,09/09/2016,DEB,Amazon UK Marketpl,37.99,,14656.65,Amazon,Swansea,Uk
5579,5580,09/09/2016,DEB,Amazon UK Marketpl,9.89,,14694.64,Amazon,Swansea,Uk
5580,5581,09/09/2016,DEB,AMAZON UK RETAIL A,21.7,,14704.53,Amazon,Swansea,Uk
5581,5582,09/09/2016,CPT,LOYD WALES UNIV SW,50.0,,14726.23,Cash,Swansea,Uk
5582,5583,09/09/2016,DD,LV LIFE,37.12,,14776.23,Insurance,Swansea,Uk
5583,5584,09/09/2016,BP,SAVE THE CHANGE,0.61,,14813.35,Savings,Swansea,Uk
5584,5585,08/09/2016,DEB,Amazon UK Marketpl,14.95,,14813.96,Amazon,Swansea,Uk
5585,5586,08/09/2016,DEB,Amazon UK Marketpl,9.9,,14828.91,Amazon,Swansea,Uk
5586,5587,08/09/2016,DEB,Amazon UK Marketpl,5.54,,14838.81,Amazon,Swansea,Uk
5587,5588,06/09/2016,BP,SAVE THE CHANGE,0.75,,14844.35,Savings,Swansea,Uk
5588,5589,05/09/2016,DEB,NON-STG PURCH FEE,1.0,,14845.1,Others,Swansea,Uk
5589,5590,05/09/2016,DEB,NON-STG TRANS FEE,1.77,,14846.1,Others,Swansea,Uk
5590,5591,05/09/2016,DEB,TERRA RESTAURANTE,59.25,,14847.87,Dine Out,Porto,Portugal
5591,5592,05/09/2016,DD,ASSURANT INTER LTD,39.85,,14907.12,Insurance,Swansea,Uk
5592,5593,05/09/2016,BP,SAVE THE CHANGE,0.4,,14946.97,Savings,Swansea,Uk
5593,5594,02/09/2016,DEB,ARRIVA TRAINS WALE,72.6,,14947.37,Travel,,
5594,5595,01/09/2016,FEE,ACCOUNT FEE,9.95,,15019.97,Bills,Swansea,Uk
5595,5596,01/09/2016,DD,NATWEST BANK,828.49,,15029.92,Mortgage,Swansea,Uk
5596,5597,01/09/2016,DD,CC SWANSEA C.TAX,127.0,,15858.41,Bills,Swansea,Uk
5597,5598,01/09/2016,DD,GOOD ENERGY GAS,43.0,,15985.41,Bills,Swansea,Uk
5598,5599,01/09/2016,DD,GOOD ENERGY LTD,42.0,,16028.41,Bills,Swansea,Uk
5599,5600,01/09/2016,DD,DWR CYMRU W WATER,29.5,,16070.41,Bills,Swansea,Uk
5600,5601,01/09/2016,DD,TV LICENCE MBP,12.12,,16099.91,Bills,Swansea,Uk
5601,5602,01/09/2016,SO,ESAVINGS ACCOUNT,300.0,,16112.03,Savings,Swansea,Uk
5602,5603,01/09/2016,BP,SAVE THE CHANGE,0.67,,16412.03,Savings,Swansea,Uk
5603,5604,31/08/2016,DEB,Amazon UK Marketpl,19.33,,16412.7,Amazon,Swansea,Uk
5604,5605,31/08/2016,BP,SAVE THE CHANGE,0.47,,16432.03,Savings,Swansea,Uk
5605,5606,31/08/2016,BGC,SWANSEA UNI - PAY,,3085.63,16432.5,Paycheck,Swansea,Uk
5606,5607,30/08/2016,DEB,Amazon UK Marketpl,19.99,,13346.87,Amazon,Swansea,Uk
5607,5608,30/08/2016,DEB,Amazon UK Marketpl,13.96,,13366.86,Amazon,Swansea,Uk
5608,5609,30/08/2016,DEB,Amazon UK Marketpl,13.58,,13380.82,Amazon,Swansea,Uk
5609,5610,30/08/2016,CPT,LOYD WALES UNIV SW,30.0,,13394.4,Cash,Swansea,Uk
5610,5611,30/08/2016,BP,SAVE THE CHANGE,0.22,,13424.4,Savings,Swansea,Uk
5611,5612,30/08/2016,CPT,LNK UNION STREET,30.0,,13424.62,Cash,,
5612,5613,26/08/2016,DEB,Amazon UK Marketpl,6.78,,13454.62,Amazon,Swansea,Uk
5613,5614,26/08/2016,CPT,LOYD WALES UNIV SW,30.0,,13461.4,Cash,Swansea,Uk
5614,5615,26/08/2016,DD,UCU B ACCOUNT,22.37,,13491.4,Others,Swansea,Uk
5615,5616,26/08/2016,BP,SAVE THE CHANGE,1.21,,13513.77,Savings,Swansea,Uk
5616,5617,25/08/2016,DEB,Amazon UK Marketpl,5.16,,13514.98,Amazon,Swansea,Uk
5617,5618,25/08/2016,DEB,AMAZON UK RETAIL A,3.63,,13520.14,Amazon,Swansea,Uk
5618,5619,25/08/2016,FPO,FB EDMUNDS,31.25,,13523.77,,,
5619,5620,25/08/2016,BP,SAVE THE CHANGE,1.03,,13555.02,Savings,Swansea,Uk
5620,5621,24/08/2016,DEB,Amazon UK Marketpl,89.99,,13556.05,Amazon,Swansea,Uk
5621,5622,24/08/2016,DEB,Amazon UK Marketpl,21.25,,13646.04,Amazon,Swansea,Uk
5622,5623,24/08/2016,DEB,AMAZON UK RETAIL A,13.73,,13667.29,Amazon,Swansea,Uk
5623,5624,24/08/2016,DEB,Amazon UK Marketpl,,17.99,13681.02,Supplementary Income,Swansea,Uk
5624,5625,24/08/2016,CPT,LOYD WALES UNIV SW,50.0,,13663.03,Cash,Swansea,Uk
5625,5626,24/08/2016,BP,SAVE THE CHANGE,0.29,,13713.03,Savings,Swansea,Uk
5626,5627,23/08/2016,DEB,Amazon UK Marketpl,9.72,,13713.32,Amazon,Swansea,Uk
5627,5628,23/08/2016,DEB,Amazon UK Marketpl,8.99,,13723.04,Amazon,Swansea,Uk
5628,5629,23/08/2016,BP,SAVE THE CHANGE,1.43,,13732.03,Savings,Swansea,Uk
5629,5630,22/08/2016,DEB,Amazon UK Marketpl,11.38,,13733.46,Amazon,Swansea,Uk
5630,5631,22/08/2016,DEB,Amazon UK Retail,58.2,,13744.84,Amazon,Swansea,Uk
5631,5632,22/08/2016,DEB,Amazon UK Marketpl,49.99,,13803.04,Amazon,Swansea,Uk
5632,5633,22/08/2016,DD,VIRGIN MEDIA PYMTS,27.99,,13853.03,Bills,Nottingham,Uk
5633,5634,22/08/2016,DD,CORGI HOMEPLAN CA,19.5,,13881.02,Home Improvement,Swansea,Uk
5634,5635,19/08/2016,FPI,MARIANA MILLS,,175.0,13900.52,Supplementary Income,Swansea,Uk
5635,5636,17/08/2016,DEB,CROWNE PLAZA,135.0,,13725.52,Hotels,,
5636,5637,17/08/2016,BP,SAVE THE CHANGE,0.2,,13860.52,Savings,Swansea,Uk
5637,5638,16/08/2016,DEB,CROWNE PLAZA,25.8,,13860.72,Hotels,,
5638,5639,16/08/2016,DD,O2,17.32,,13886.52,Other Shopping,Swansea,Uk
5639,5640,16/08/2016,BP,SAVE THE CHANGE,1.0,,13903.84,Savings,Swansea,Uk
5640,5641,15/08/2016,DEB,JS ONLINE GROCERY,368.5,,13904.84,Groceries,Swansea,Uk
5641,5642,15/08/2016,DEB,Amazon UK Marketpl,17.99,,14273.34,Amazon,Swansea,Uk
5642,5643,15/08/2016,DEB,GWR WEBSALES ECOM,137.0,,14291.33,Travel,,
5643,5644,15/08/2016,DEB,AMAZON UK RETAIL A,99.51,,14428.33,Amazon,Swansea,Uk
5644,5645,15/08/2016,CPT,LNK ARRIVA TRAINS,50.0,,14527.84,Cash,,
5645,5646,15/08/2016,BP,SAVE THE CHANGE,0.1,,14577.84,Savings,Swansea,Uk
5646,5647,12/08/2016,DEB,Amazon UK Marketpl,16.9,,14577.94,Amazon,Swansea,Uk
5647,5648,12/08/2016,CPT,LOYD WALES UNIV SW,50.0,,14594.84,Amazon,Swansea,Uk
5648,5649,09/08/2016,BP,SAVE THE CHANGE,0.19,,14644.84,Savings,Swansea,Uk
5649,5650,08/08/2016,DEB,Amazon UK Marketpl,2.81,,14645.03,Amazon,Swansea,Uk
5650,5651,08/08/2016,DD,LV LIFE,37.12,,14647.84,Insurance,Swansea,Uk
5651,5652,05/08/2016,BP,SAVE THE CHANGE,1.03,,14684.96,Savings,Swansea,Uk
5652,5653,04/08/2016,DEB,Amazon UK Marketpl,13.89,,14685.99,Amazon,Swansea,Uk
5653,5654,04/08/2016,DEB,NON-STG PURCH FEE,1.0,,14699.88,Others,Swansea,Uk
5654,5655,04/08/2016,DEB,NON-STG TRANS FEE,0.18,,14700.88,Others,Swansea,Uk
5655,5656,04/08/2016,DEB,KLM NETHERLA074821,6.08,,14701.06,Travel,,
5656,5657,03/08/2016,DD,ASSURANT INTER LTD,35.56,,14707.14,Insurance,Swansea,Uk
5657,5658,02/08/2016,BP,SAVE THE CHANGE,0.52,,14742.7,Savings,Swansea,Uk
5658,5659,02/08/2016,BGC,SWANSEA UNIVERSITY,,1652.84,14743.22,Supplementary Income,Swansea,Uk
5659,5660,01/08/2016,FEE,ACCOUNT FEE,9.95,,13090.38,Bills,Swansea,Uk
5660,5661,01/08/2016,DEB,Amazon UK Marketpl,9.48,,13100.33,Amazon,Swansea,Uk
5661,5662,01/08/2016,CPT,LOYD WALES UNIV SW,100.0,,13109.81,Cash,Swansea,Uk
5662,5663,01/08/2016,DD,NATWEST BANK,828.49,,13209.81,Mortgage,Swansea,Uk
5663,5664,01/08/2016,DD,CC SWANSEA C.TAX,127.0,,14038.3,Bills,Swansea,Uk
5664,5665,01/08/2016,DD,GOOD ENERGY GAS,43.0,,14165.3,Bills,Swansea,Uk
5665,5666,01/08/2016,DD,DWR CYMRU W WATER,29.5,,14208.3,Bills,Swansea,Uk
5666,5667,01/08/2016,DD,GOOD ENERGY LTD,13.0,,14237.8,Bills,Swansea,Uk
5667,5668,01/08/2016,DD,TV LICENCE MBP,12.12,,14250.8,Bills,Swansea,Uk
5668,5669,01/08/2016,SO,ESAVINGS ACCOUNT,300.0,,14262.92,Savings,Swansea,Uk
5669,5670,01/08/2016,BP,SAVE THE CHANGE,0.52,,14562.92,Savings,Swansea,Uk
5670,5671,29/07/2016,DEB,Amazon UK Marketpl,16.48,,14563.44,Amazon,Swansea,Uk
5671,5672,29/07/2016,CPT,LOYD WALES UNIV SW,50.0,,14579.92,Cash,Swansea,Uk
5672,5673,29/07/2016,DD,UCU B ACCOUNT,22.37,,14629.92,Others,Swansea,Uk
5673,5674,29/07/2016,BP,SAVE THE CHANGE,0.6,,14652.29,Savings,Swansea,Uk
5674,5675,29/07/2016,BGC,SWANSEA UNI - PAY,,3085.64,14652.89,Paycheck,Swansea,Uk
5675,5676,28/07/2016,DEB,Amazon UK Retail,16.74,,11567.25,Amazon,Swansea,Uk
5676,5677,28/07/2016,DEB,Amazon UK Marketpl,13.98,,11583.99,Amazon,Swansea,Uk
5677,5678,28/07/2016,DEB,Amazon Svcs Europe,6.68,,11597.97,Amazon,Swansea,Uk
5678,5679,28/07/2016,BP,SAVE THE CHANGE,1.32,,11604.65,Savings,Swansea,Uk
5679,5680,27/07/2016,DEB,Amazon UK Marketpl,14.22,,11605.97,Amazon,Swansea,Uk
5680,5681,27/07/2016,DEB,Amazon UK Marketpl,10.46,,11620.19,Amazon,Swansea,Uk
5681,5682,27/07/2016,CPT,LOYD WALES UNIV SW,20.0,,11630.65,Cash,Swansea,Uk
5682,5683,27/07/2016,BP,SAVE THE CHANGE,0.01,,11650.65,Savings,Swansea,Uk
5683,5684,26/07/2016,DEB,Amazon UK Marketpl,15.99,,11650.66,Amazon,Swansea,Uk
5684,5685,25/07/2016,DD,CORGI HOMEPLAN CA,19.5,,11666.65,Home Improvement,Swansea,Uk
5685,5686,25/07/2016,BP,SAVE THE CHANGE,1.38,,11686.15,Savings,Swansea,Uk
5686,5687,25/07/2016,BGC,UNIVERSITY OF EAST,,167.84,11687.53,Supplementary Income,Swansea,Uk
5687,5688,22/07/2016,DEB,Amazon UK Marketpl,18.13,,11519.69,Amazon,Swansea,Uk
5688,5689,22/07/2016,DEB,AMAZON UK RETAIL A,9.49,,11537.82,Amazon,Swansea,Uk
5689,5690,22/07/2016,CPT,LOYD WALES UNIV SW,50.0,,11547.31,Cash,Swansea,Uk
5690,5691,22/07/2016,BP,SAVE THE CHANGE,0.42,,11597.31,Savings,Swansea,Uk
5691,5692,21/07/2016,DEB,Amazon UK Retail,9.9,,11597.73,Amazon,Swansea,Uk
5692,5693,21/07/2016,DEB,Amazon UK Marketpl,8.68,,11607.63,Amazon,Swansea,Uk
5693,5694,21/07/2016,DD,VIRGIN MEDIA PYMTS,27.99,,11616.31,Bills,Nottingham,Uk
5694,5695,21/07/2016,BP,SAVE THE CHANGE,0.02,,11644.3,Savings,Swansea,Uk
5695,5696,20/07/2016,DEB,EXPEDIA 1126326416,774.98,,11644.32,Travel,,
5696,5697,20/07/2016,BP,SAVE THE CHANGE,0.77,,12419.3,Savings,Swansea,Uk
5697,5698,19/07/2016,DEB,Amazon Svcs Europe,12.23,,12420.07,Amazon,Swansea,Uk
5698,5699,19/07/2016,BP,SAVE THE CHANGE,0.74,,12432.3,Savings,Swansea,Uk
5699,5700,18/07/2016,DEB,EASYJET   EQWFKG,383.96,,12433.04,Travel,,
5700,5701,18/07/2016,DEB,Amazon UK Marketpl,7.3,,12817.0,Amazon,Swansea,Uk
5701,5702,18/07/2016,DD,O2,22.81,,12824.3,Other Shopping,Swansea,Uk
5702,5703,18/07/2016,BP,SAVE THE CHANGE,0.95,,12847.11,Savings,Swansea,Uk
5703,5704,18/07/2016,CPT,SBY  SWANSEA UPL C,50.0,,12848.06,Other Shopping,Swansea,Uk
5704,5705,18/07/2016,DEB,Amazon UK Marketpl,23.05,,12898.06,Amazon,Swansea,Uk
5705,5706,15/07/2016,CPT,LOYD WALES UNIV SW,50.0,,12921.11,Cash,Swansea,Uk
5706,5707,15/07/2016,BGC,SWANSEA UNIVERSITY,,858.01,12971.11,Supplementary Income,Swansea,Uk
5707,5708,14/07/2016,BP,SAVE THE CHANGE,1.23,,12113.1,Savings,Swansea,Uk
5708,5709,13/07/2016,DEB,Amazon UK Marketpl,32.29,,12114.33,Amazon,Swansea,Uk
5709,5710,13/07/2016,DEB,Amazon UK Marketpl,17.48,,12146.62,Amazon,Swansea,Uk
5710,5711,13/07/2016,CPT,LOYD WALES UNIV SW,50.0,,12164.1,Cash,Swansea,Uk
5711,5712,12/07/2016,CPT,LOYD WALES UNIV SW,50.0,,12214.1,Cash,Swansea,Uk
5712,5713,12/07/2016,BP,SAVE THE CHANGE,0.34,,12264.1,Savings,Swansea,Uk
5713,5714,11/07/2016,DEB,Amazon UK Marketpl,13.98,,12264.44,Amazon,Swansea,Uk
5714,5715,11/07/2016,DEB,Amazon UK Marketpl,8.68,,12278.42,Amazon,Swansea,Uk
5715,5716,08/07/2016,CPT,LOYD WALES UNIV SW,60.0,,12287.1,Cash,Swansea,Uk
5716,5717,08/07/2016,DD,LV LIFE,37.12,,12347.1,Insurance,Swansea,Uk
5717,5718,07/07/2016,DD,ASSURANT INTER LTD,35.56,,12384.22,Insurance,Swansea,Uk
5718,5719,07/07/2016,BP,SAVE THE CHANGE,0.71,,12419.78,Savings,Swansea,Uk
5719,5720,06/07/2016,FPI,MARIANA MILLS,,300.0,12420.49,Supplementary Income,Swansea,Uk
5720,5721,06/07/2016,DEB,NON-STG PURCH FEE,1.0,,12120.49,Others,Swansea,Uk
5721,5722,06/07/2016,DEB,NON-STG TRANS FEE,28.89,,12121.49,Others,Swansea,Uk
5722,5723,06/07/2016,DEB,ALEXANDER BEACH HO,966.29,,12150.38,Hotels,Malia,Greece
5723,5724,06/07/2016,BP,SAVE THE CHANGE,0.06,,13116.67,Savings,Swansea,Uk
5724,5725,05/07/2016,CPT,LOYD SWANSEA UNIVE,30.0,,13116.73,Cash,Swansea,Uk
5725,5726,05/07/2016,DEB,Amazon UK Marketpl,39.94,,13146.73,Amazon,Swansea,Uk
5726,5727,05/07/2016,BP,SAVE THE CHANGE,0.67,,13186.67,Savings,Swansea,Uk
5727,5728,04/07/2016,DEB,Amazon UK Retail,21.33,,13187.34,Amazon,Swansea,Uk
5728,5729,04/07/2016,DEB,SWANSEA UNIVERSITY,1100.0,,13208.67,Others,Swansea,Uk
5729,5730,04/07/2016,CPT,LNK BRISTOL LANDSI,50.0,,14308.67,Cash,Bristol,Uk
5730,5731,01/07/2016,FEE,ACCOUNT FEE,9.95,,14358.67,Bills,Swansea,Uk
5731,5732,01/07/2016,DD,NATWEST BANK,828.49,,14368.62,Mortgage,Swansea,Uk
5732,5733,01/07/2016,DD,CC SWANSEA C.TAX,127.0,,15197.11,Bills,Swansea,Uk
5733,5734,01/07/2016,DD,GOOD ENERGY GAS,43.0,,15324.11,Bills,Swansea,Uk
5734,5735,01/07/2016,DD,DWR CYMRU W WATER,29.5,,15367.11,Bills,Swansea,Uk
5735,5736,01/07/2016,DD,GOOD ENERGY LTD,13.0,,15396.61,Bills,Swansea,Uk
5736,5737,01/07/2016,DD,TV LICENCE MBP,12.12,,15409.61,Bills,Swansea,Uk
5737,5738,01/07/2016,SO,ESAVINGS ACCOUNT,300.0,,15421.73,Savings,Swansea,Uk
5738,5739,30/06/2016,DD,UCU B ACCOUNT,22.37,,15721.73,Others,Swansea,Uk
5739,5740,30/06/2016,BGC,SWANSEA UNI - PAY,,3085.63,15744.1,Paycheck,Swansea,Uk
5740,5741,28/06/2016,BP,SAVE THE CHANGE,0.4,,12658.47,Savings,Swansea,Uk
5741,5742,27/06/2016,DEB,FOREIGN CASH FEE,2.87,,12658.87,Travel,,
5742,5743,27/06/2016,DEB,Stalida-Malia,191.84,,12661.74,Travel,Malia,Greece
5743,5744,27/06/2016,DEB,ARRIVA TRAINS WALE,72.6,,12853.58,Travel,,
5744,5745,27/06/2016,DEB,J B PEARCE LTD,65.0,,12926.18,Travel,Bristol,Uk
5745,5746,24/06/2016,BP,SAVE THE CHANGE,0.51,,12991.18,Savings,Swansea,Uk
5746,5747,23/06/2016,DEB,Amazon UK Marketpl,5.49,,12991.69,Amazon,Swansea,Uk
5747,5748,23/06/2016,DD,CORGI HOMEPLAN CA,19.5,,12997.18,Home Improvement,Swansea,Uk
5748,5749,22/06/2016,BP,SAVE THE CHANGE,1.02,,13016.68,Savings,Swansea,Uk
5749,5750,21/06/2016,CPT,LNK SWANSEA WIND S,50.0,,13017.7,Cash,Swansea,Uk
5750,5751,21/06/2016,DEB,Amazon UK Retail,22.49,,13067.7,Amazon,Swansea,Uk
5751,5752,21/06/2016,DEB,Amazon UK Marketpl,15.49,,13090.19,Amazon,Swansea,Uk
5752,5753,21/06/2016,DD,VIRGIN MEDIA PYMTS,27.99,,13105.68,Bills,Nottingham,Uk
5753,5754,21/06/2016,BP,SAVE THE CHANGE,0.67,,13133.67,Savings,Swansea,Uk
5754,5755,20/06/2016,DEB,Amazon UK Marketpl,11.99,,13134.34,Amazon,Swansea,Uk
5755,5756,20/06/2016,DEB,Amazon UK Marketpl,4.34,,13146.33,Amazon,Swansea,Uk
5756,5757,20/06/2016,DEB,SKYPE SUBSCRIPTION,10.0,,13150.67,Bills,Nottingham,Uk
5757,5758,17/06/2016,CPT,LOYD WALES UNIV SW,20.0,,13160.67,Cash,Swansea,Uk
5758,5759,17/06/2016,BP,SAVE THE CHANGE,0.94,,13180.67,Savings,Swansea,Uk
5759,5760,16/06/2016,DEB,Amazon UK Marketpl,5.06,,13181.61,Amazon,Swansea,Uk
5760,5761,16/06/2016,DD,O2,16.83,,13186.67,Other Shopping,Swansea,Uk
5761,5762,15/06/2016,BP,SAVE THE CHANGE,0.64,,13203.5,Savings,Swansea,Uk
5762,5763,14/06/2016,DEB,Amazon UK Marketpl,3.36,,13204.14,Amazon,Swansea,Uk
5763,5764,14/06/2016,BP,SAVE THE CHANGE,0.43,,13207.5,Savings,Swansea,Uk
5764,5765,13/06/2016,DEB,JS ONLINE GROCERY,235.83,,13207.93,Groceries,Swansea,Uk
5765,5766,13/06/2016,DEB,Amazon UK Marketpl,26.74,,13443.76,Amazon,Swansea,Uk
5766,5767,08/06/2016,DD,LV LIFE,37.12,,13470.5,Insurance,Swansea,Uk
5767,5768,08/06/2016,DEB,NON-STG CASH FEE,2.0,,13507.62,Others,Swansea,Uk
5768,5769,08/06/2016,DEB,NON-STG TRANS FEE,3.54,,13509.62,Others,Swansea,Uk
5769,5770,08/06/2016,DEB,ING BANK,118.56,,13513.16,Others,Swansea,Uk
5770,5771,07/06/2016,BP,SAVE THE CHANGE,1.93,,13631.72,Savings,Swansea,Uk
5771,5772,06/06/2016,DEB,SCHIMMELPENNICKHUY,385.66,,13633.65,,,
5772,5773,06/06/2016,DEB,NON-STG PURCH FEE,1.0,,14019.31,Others,Swansea,Uk
5773,5774,06/06/2016,DEB,NON-STG TRANS FEE,1.25,,14020.31,Others,Swansea,Uk
5774,5775,06/06/2016,DEB,NS SCHIPHOL,42.03,,14021.56,Travel,Amsterdam,Netherlands
5775,5776,06/06/2016,DEB,Amazon UK Marketpl,9.75,,14063.59,Amazon,Swansea,Uk
5776,5777,06/06/2016,DEB,Amazon UK Marketpl,3.63,,14073.34,Amazon,Swansea,Uk
5777,5778,06/06/2016,BP,SAVE THE CHANGE,1.25,,14076.97,Savings,Swansea,Uk
5778,5779,03/06/2016,DEB,Amazon UK Marketpl,15.21,,14078.22,Amazon,Swansea,Uk
5779,5780,03/06/2016,DEB,Amazon UK Marketpl,5.54,,14093.43,Amazon,Swansea,Uk
5780,5781,03/06/2016,DD,ASSURANT INTER LTD,35.56,,14098.97,Insurance,Swansea,Uk
5781,5782,03/06/2016,BP,SAVE THE CHANGE,0.65,,14134.53,Savings,Swansea,Uk
5782,5783,02/06/2016,DEB,Amazon UK Retail,12.35,,14135.18,Amazon,Swansea,Uk
5783,5784,02/06/2016,BP,SAVE THE CHANGE,0.81,,14147.53,Savings,Swansea,Uk
5784,5785,01/06/2016,FEE,ACCOUNT FEE,9.95,,14148.34,Bills,Swansea,Uk
5785,5786,01/06/2016,DEB,Amazon UK Marketpl,4.2,,14158.29,Amazon,Swansea,Uk
5786,5787,01/06/2016,DEB,Amazon UK Marketpl,3.99,,14162.49,Amazon,Swansea,Uk
5787,5788,01/06/2016,DD,NATWEST BANK,828.49,,14166.48,Mortgage,Swansea,Uk
5788,5789,01/06/2016,DD,CC SWANSEA C.TAX,127.0,,14994.97,Bills,Swansea,Uk
5789,5790,01/06/2016,DD,GOOD ENERGY GAS,43.0,,15121.97,Bills,Swansea,Uk
5790,5791,01/06/2016,DD,DWR CYMRU W WATER,29.5,,15164.97,Bills,Swansea,Uk
5791,5792,01/06/2016,DD,GOOD ENERGY LTD,13.0,,15194.47,Bills,Swansea,Uk
5792,5793,01/06/2016,DD,TV LICENCE MBP,12.12,,15207.47,Bills,Swansea,Uk
5793,5794,01/06/2016,SO,ESAVINGS ACCOUNT,300.0,,15219.59,Savings,Swansea,Uk
5794,5795,01/06/2016,BP,SAVE THE CHANGE,0.33,,15519.59,Savings,Swansea,Uk
5795,5796,31/05/2016,DEB,EASYJET   000EQP,665.72,,15519.92,Travel,,
5796,5797,31/05/2016,DEB,Amazon UK Marketpl,6.95,,16185.64,Amazon,Swansea,Uk
5797,5798,31/05/2016,DD,UCU B ACCOUNT,22.37,,16192.59,Others,Swansea,Uk
5798,5799,31/05/2016,BP,SAVE THE CHANGE,0.57,,16214.96,Savings,Swansea,Uk
5799,5800,31/05/2016,BGC,SWANSEA UNI - PAY,,3085.63,16215.53,Paycheck,Swansea,Uk
5800,5801,31/05/2016,CPT,LNK SWANSEA 2,50.0,,13129.9,Cash,Swansea,Uk
5801,5802,27/05/2016,DEB,ARRIVA TRAINS WALE,137.7,,13179.9,Travel,,
5802,5803,27/05/2016,DEB,Amazon UK Marketpl,3.73,,13317.6,Amazon,Swansea,Uk
5803,5804,27/05/2016,BP,SAVE THE CHANGE,0.01,,13321.33,Savings,Swansea,Uk
5804,5805,26/05/2016,DEB,Amazon UK Marketpl,17.99,,13321.34,Amazon,Swansea,Uk
5805,5806,26/05/2016,BP,SAVE THE CHANGE,1.16,,13339.33,Savings,Swansea,Uk
5806,5807,25/05/2016,DEB,Amazon UK Marketpl,9.75,,13340.49,Amazon,Swansea,Uk
5807,5808,25/05/2016,DEB,Amazon UK Marketpl,8.09,,13350.24,Amazon,Swansea,Uk
5808,5809,25/05/2016,CPT,LOYD WALES UNIV SW,50.0,,13358.33,Cash,Swansea,Uk
5809,5810,25/05/2016,BGC,UNIVERSITY OF OXFO,,340.0,13408.33,Supplementary Income,Swansea,Uk
5810,5811,24/05/2016,BP,SAVE THE CHANGE,0.93,,13068.33,Savings,Swansea,Uk
5811,5812,23/05/2016,DEB,AMAZON MKTPLACE PM,10.9,,13069.26,Amazon,Swansea,Uk
5812,5813,23/05/2016,DEB,Amazon UK Marketpl,35.17,,13080.16,Amazon,Swansea,Uk
5813,5814,23/05/2016,DD,VIRGIN MEDIA PYMTS,27.99,,13115.33,Bills,Nottingham,Uk
5814,5815,23/05/2016,DD,CORGI HOMEPLAN CA,19.5,,13143.32,Home Improvement,Swansea,Uk
5815,5816,20/05/2016,CPT,LOYD WALES UNIV SW,50.0,,13162.82,Cash,Swansea,Uk
5816,5817,18/05/2016,CPT,LOYD WALES UNIV SW,40.0,,13212.82,Cash,Swansea,Uk
5817,5818,18/05/2016,BP,SAVE THE CHANGE,0.21,,13252.82,Savings,Swansea,Uk
5818,5819,17/05/2016,DEB,Amazon UK Marketpl,5.79,,13253.03,Amazon,Swansea,Uk
5819,5820,17/05/2016,BP,SAVE THE CHANGE,1.34,,13258.82,Savings,Swansea,Uk
5820,5821,16/05/2016,DEB,Amazon UK Retail,17.17,,13260.16,Amazon,Swansea,Uk
5821,5822,16/05/2016,DEB,Amazon UK Marketpl,11.5,,13277.33,Amazon,Swansea,Uk
5822,5823,16/05/2016,DEB,Amazon UK Retail,9.99,,13288.83,Amazon,Swansea,Uk
5823,5824,16/05/2016,DD,O2,21.82,,13298.82,Other Shopping,Swansea,Uk
5824,5825,13/05/2016,BP,SAVE THE CHANGE,0.32,,13320.64,Savings,Swansea,Uk
5825,5826,13/05/2016,BGC,SWANSEA UNIVERSITY,,1019.74,13320.96,Supplementary Income,Swansea,Uk
5826,5827,12/05/2016,DEB,Amazon UK Retail,7.99,,12301.22,Amazon,Swansea,Uk
5827,5828,12/05/2016,DEB,AMAZON MKTPLACE PM,6.69,,12309.21,Amazon,Swansea,Uk
5828,5829,12/05/2016,BP,SAVE THE CHANGE,0.22,,12315.9,Savings,Swansea,Uk
5829,5830,11/05/2016,DEB,Amazon UK Retail,17.96,,12316.12,Amazon,Swansea,Uk
5830,5831,11/05/2016,DEB,Amazon UK Marketpl,12.82,,12334.08,Amazon,Swansea,Uk
5831,5832,11/05/2016,BP,SAVE THE CHANGE,1.42,,12346.9,Savings,Swansea,Uk
5832,5833,10/05/2016,DEB,AMAZON MKTPLACE PM,15.1,,12348.32,Amazon,Swansea,Uk
5833,5834,10/05/2016,DEB,Amazon UK Marketpl,10.87,,12363.42,Amazon,Swansea,Uk
5834,5835,10/05/2016,DEB,Amazon UK Retail,8.97,,12374.29,Amazon,Swansea,Uk
5835,5836,10/05/2016,DEB,Amazon UK Marketpl,5.64,,12383.26,Amazon,Swansea,Uk
5836,5837,10/05/2016,BP,SAVE THE CHANGE,1.15,,12388.9,Savings,Swansea,Uk
5837,5838,09/05/2016,DEB,Amazon UK Marketpl,5.82,,12390.05,Amazon,Swansea,Uk
5838,5839,09/05/2016,DEB,Amazon UK Marketpl,2.03,,12395.87,Amazon,Swansea,Uk
5839,5840,09/05/2016,DD,LV LIFE,37.12,,12397.9,Insurance,Swansea,Uk
5840,5841,06/05/2016,FPO,JAMES DAVIES,40.0,,12435.02,Services,Swansea,Uk
5841,5842,06/05/2016,BP,SAVE THE CHANGE,0.7,,12475.02,Savings,Swansea,Uk
5842,5843,05/05/2016,FPO,JAMES DAVIES,240.0,,12475.72,Services,Swansea,Uk
5843,5844,05/05/2016,DEB,HAMPTON BY HILTON,99.0,,12715.72,Hotels,,
5844,5845,05/05/2016,DEB,KLM UK  074174,168.3,,12814.72,Travel,,
5845,5846,05/05/2016,BP,SAVE THE CHANGE,0.01,,12983.02,Savings,Swansea,Uk
5846,5847,04/05/2016,DEB,Amazon UK Marketpl,3.99,,12983.03,Amazon,Swansea,Uk
5847,5848,04/05/2016,DEB,EXPEDIA 1118747955,3.0,,12987.02,Travel,,
5848,5849,04/05/2016,BP,SAVE THE CHANGE,3.55,,12990.02,Savings,Swansea,Uk
5849,5850,03/05/2016,FEE,ACCOUNT FEE,9.95,,12993.57,Bills,Swansea,Uk
5850,5851,03/05/2016,,INTEREST (GROSS),,6.33,13003.52,Interest,Swansea,Uk
5851,5852,03/05/2016,DEB,Amazon UK Marketpl,9.42,,12997.19,Amazon,Swansea,Uk
5852,5853,03/05/2016,DEB,Amazon UK Marketpl,2.0,,13006.61,Amazon,Swansea,Uk
5853,5854,03/05/2016,DEB,Amazon UK Marketpl,4.25,,13008.61,Amazon,Swansea,Uk
5854,5855,03/05/2016,DEB,Amazon UK Marketpl,3.95,,13012.86,Amazon,Swansea,Uk
5855,5856,03/05/2016,DEB,Amazon UK Marketpl,3.22,,13016.81,Amazon,Swansea,Uk
5856,5857,03/05/2016,DEB,Amazon UK Marketpl,2.27,,13020.03,Amazon,Swansea,Uk
5857,5858,03/05/2016,DEB,Amazon UK Retail,14.85,,13022.3,Amazon,Swansea,Uk
5858,5859,03/05/2016,DEB,Amazon UK Marketpl,6.49,,13037.15,Amazon,Swansea,Uk
5859,5860,03/05/2016,DD,NATWEST BANK,828.49,,13043.64,Mortgage,Swansea,Uk
5860,5861,03/05/2016,DD,CC SWANSEA C.TAX,127.0,,13872.13,Bills,Swansea,Uk
5861,5862,03/05/2016,DD,GOOD ENERGY GAS,43.0,,13999.13,Bills,Swansea,Uk
5862,5863,03/05/2016,DD,ASSURANT INTER LTD,35.56,,14042.13,Insurance,Swansea,Uk
5863,5864,03/05/2016,DD,DWR CYMRU W WATER,29.5,,14077.69,Bills,Swansea,Uk
5864,5865,03/05/2016,DD,GOOD ENERGY LTD,13.0,,14107.19,Bills,Swansea,Uk
5865,5866,03/05/2016,DD,TV LICENCE MBP,12.12,,14120.19,Bills,Swansea,Uk
5866,5867,03/05/2016,SO,ESAVINGS ACCOUNT,300.0,,14132.31,Savings,Swansea,Uk
5867,5868,03/05/2016,BP,SAVE THE CHANGE,0.68,,14432.31,Savings,Swansea,Uk
5868,5869,03/05/2016,CPT,LNK SWANSEA WIND S,60.0,,14432.99,Cash,Swansea,Uk
5869,5870,29/04/2016,DEB,Amazon Svcs Europe,8.82,,14492.99,Amazon,Swansea,Uk
5870,5871,29/04/2016,DEB,Amazon UK Marketpl,8.5,,14501.81,Amazon,Swansea,Uk
5871,5872,29/04/2016,CPT,LOYD WALES UNIV SW,40.0,,14510.31,Cash,Swansea,Uk
5872,5873,29/04/2016,DD,UCU B ACCOUNT,22.37,,14550.31,Others,Swansea,Uk
5873,5874,29/04/2016,BGC,SWANSEA UNI - PAY,,3085.64,14572.68,Paycheck,Swansea,Uk
5874,5875,28/04/2016,BP,SAVE THE CHANGE,1.25,,11487.04,Savings,Swansea,Uk
5875,5876,27/04/2016,DEB,Amazon UK Marketpl,23.49,,11488.29,Amazon,Swansea,Uk
5876,5877,27/04/2016,CPT,LOYD WALES UNIV SW,50.0,,11511.78,Cash,Swansea,Uk
5877,5878,27/04/2016,DEB,Amazon UK Marketpl,9.26,,11561.78,Amazon,Swansea,Uk
5878,5879,26/04/2016,BP,SAVE THE CHANGE,1.46,,11571.04,Savings,Swansea,Uk
5879,5880,25/04/2016,DEB,Amazon UK Retail,34.99,,11572.5,Amazon,Swansea,Uk
5880,5881,25/04/2016,DEB,Amazon UK Marketpl,16.45,,11607.49,Amazon,Swansea,Uk
5881,5882,25/04/2016,DEB,Amazon UK Marketpl,13.99,,11623.94,Amazon,Swansea,Uk
5882,5883,25/04/2016,DEB,Amazon UK Marketpl,3.87,,11637.93,Amazon,Swansea,Uk
5883,5884,25/04/2016,DEB,Amazon UK Marketpl,12.86,,11641.8,Amazon,Swansea,Uk
5884,5885,25/04/2016,DEB,Amazon UK Marketpl,1.95,,11654.66,Amazon,Swansea,Uk
5885,5886,25/04/2016,DEB,Amazon UK Retail,26.43,,11656.61,Amazon,Swansea,Uk
5886,5887,25/04/2016,DD,CORGI HOMEPLAN CA,19.5,,11683.04,Home Improvement,Swansea,Uk
5887,5888,22/04/2016,CPT,LOYD WALES UNIV SW,40.0,,11702.54,Cash,Swansea,Uk
5888,5889,22/04/2016,DEP,SWANSEA UNIVERSITY,,491.23,11742.54,Supplementary Income,Swansea,Uk
5889,5890,22/04/2016,BP,SAVE THE CHANGE,0.07,,11251.31,Savings,Swansea,Uk
5890,5891,21/04/2016,DEB,HMSHOST AMSTERDAM,21.93,,11251.38,Dine Out,Amsterdam,Netherlands
5891,5892,21/04/2016,DD,VIRGIN MEDIA PYMTS,27.99,,11273.31,Bills,Nottingham,Uk
5892,5893,21/04/2016,BP,SAVE THE CHANGE,0.01,,11301.3,Savings,Swansea,Uk
5893,5894,20/04/2016,DEB,Amazon UK Retail,11.99,,11301.31,Amazon,Swansea,Uk
5894,5895,19/04/2016,BP,SAVE THE CHANGE,0.99,,11313.3,Savings,Swansea,Uk
5895,5896,18/04/2016,DEB,HMSHOST AMSTERDAM,30.22,,11314.29,Dine Out,Amsterdam,Netherlands
5896,5897,18/04/2016,DEB,NON-STG PURCH FEE,1.0,,11344.51,Others,Swansea,Uk
5897,5898,18/04/2016,DEB,NON-STG TRANS FEE,0.14,,11345.51,Others,Swansea,Uk
5898,5899,18/04/2016,DEB,WWW.HOTSPOTSCHIPHO,4.79,,11345.65,,,
5899,5900,18/04/2016,DD,O2,38.92,,11350.44,Other Shopping,Swansea,Uk
5900,5901,18/04/2016,BP,SAVE THE CHANGE,1.42,,11389.36,Savings,Swansea,Uk
5901,5902,15/04/2016,DEB,Shop 1/ Fashion Sh,72.28,,11390.78,Clothes,,
5902,5903,15/04/2016,DEB,ARRIVA TRAINS WALE,8.3,,11463.06,Travel,,
5903,5904,15/04/2016,BP,SAVE THE CHANGE,0.1,,11471.36,Savings,Swansea,Uk
5904,5905,14/04/2016,DEB,JS ONLINE GROCERY,262.9,,11471.46,Groceries,Swansea,Uk
5905,5906,14/04/2016,CPT,LNK ARRIVA TRAINS,50.0,,11734.36,Cash,,
5906,5907,14/04/2016,BP,SAVE THE CHANGE,0.5,,11784.36,Savings,Swansea,Uk
5907,5908,13/04/2016,DEB,W DAVIES & SON,12.5,,11784.86,Others,Swansea,Uk
5908,5909,13/04/2016,CPT,LOYD WALES UNIV SW,40.0,,11797.36,Cash,Swansea,Uk
5909,5910,12/04/2016,DEB,THE BIKE HUB,35.0,,11837.36,Other Shopping,,
5910,5911,12/04/2016,CPT,LOYD WALES UNIV SW,50.0,,11872.36,Cash,Swansea,Uk
5911,5912,12/04/2016,BP,SAVE THE CHANGE,0.69,,11922.36,Savings,Swansea,Uk
5912,5913,11/04/2016,FPO,A.MEADOWCROFT,40.0,,11923.05,Services,Swansea,Uk
5913,5914,11/04/2016,DEB,Amazon UK Retail,7.8,,11963.05,Amazon,Swansea,Uk
5914,5915,11/04/2016,DEB,Amazon UK Marketpl,1.51,,11970.85,Amazon,Swansea,Uk
5915,5916,11/04/2016,BP,SAVE THE CHANGE,0.6,,11972.36,Savings,Swansea,Uk
5916,5917,08/04/2016,DEB,CHINA VISA SERVICE,176.0,,11972.96,Travel,,
5917,5918,08/04/2016,DEB,ARRIVA TRAINS WALE,87.4,,12148.96,Travel,,
5918,5919,08/04/2016,CPT,LOYD WALES UNIV SW,50.0,,12236.36,Cash,Swansea,Uk
5919,5920,08/04/2016,DD,LV LIFE,37.12,,12286.36,Insurance,Swansea,Uk
5920,5921,08/04/2016,BP,SAVE THE CHANGE,0.1,,12323.48,Savings,Swansea,Uk
5921,5922,07/04/2016,DEB,LUL TICKET MACHINE,4.9,,12323.58,Travel,London,Uk
5922,5923,07/04/2016,DEB,ST GILES HOTEL,239.0,,12328.48,Hotels,,
5923,5924,06/04/2016,CPT,HFX  TOTTENHAM COU,50.0,,12567.48,Cash,London,Uk
5924,5925,06/04/2016,DD,CC SWANSEA C.TAX,125.44,,12617.48,Bills,Swansea,Uk
5925,5926,06/04/2016,BP,SAVE THE CHANGE,0.1,,12742.92,Savings,Swansea,Uk
5926,5927,05/04/2016,DEB,ARRIVA TRAINS WALE,101.0,,12743.02,Travel,,
5927,5928,05/04/2016,DEB,LUL TICKET MACHINE,4.9,,12844.02,Travel,London,Uk
5928,5929,05/04/2016,DD,ASSURANT INTER LTD,35.56,,12848.92,Insurance,Swansea,Uk
5929,5930,05/04/2016,BP,SAVE THE CHANGE,2.33,,12884.48,Savings,Swansea,Uk
5930,5931,04/04/2016,DEB,Amazon UK Marketpl,74.99,,12886.81,Amazon,Swansea,Uk
5931,5932,04/04/2016,DEB,Amazon UK Marketpl,20.24,,12961.8,Amazon,Swansea,Uk
5932,5933,04/04/2016,DEB,Amazon *Mktplce EU,8.02,,12982.04,Amazon,Swansea,Uk
5933,5934,04/04/2016,DEB,Amazon UK Marketpl,5.42,,12990.06,Amazon,Swansea,Uk
5934,5935,04/04/2016,BP,SAVE THE CHANGE,0.15,,12995.48,Savings,Swansea,Uk
5935,5936,01/04/2016,FEE,ACCOUNT FEE,9.95,,12995.63,Bills,Swansea,Uk
5936,5937,01/04/2016,,INTEREST (NET),,5.07,13005.58,Interest,Swansea,Uk
5937,5938,01/04/2016,DEB,Amazon UK Marketpl,3.85,,13000.51,Amazon,Swansea,Uk
5938,5939,01/04/2016,DD,NATWEST BANK,828.49,,13004.36,Mortgage,Swansea,Uk
5939,5940,01/04/2016,DD,GOOD ENERGY GAS,43.0,,13832.85,Bills,Swansea,Uk
5940,5941,01/04/2016,DD,DWR CYMRU W WATER,14.5,,13875.85,Bills,Swansea,Uk
5941,5942,01/04/2016,DD,GOOD ENERGY LTD,13.0,,13890.35,Bills,Swansea,Uk
5942,5943,01/04/2016,DD,TV LICENCE MBP,12.12,,13903.35,Bills,Swansea,Uk
5943,5944,01/04/2016,SO,ESAVINGS ACCOUNT,300.0,,13915.47,Savings,Swansea,Uk
5944,5945,01/04/2016,BP,SAVE THE CHANGE,1.31,,14215.47,Savings,Swansea,Uk
5945,5946,31/03/2016,DEB,Amazon UK Retail,12.45,,14216.78,Amazon,Swansea,Uk
5946,5947,31/03/2016,DEB,Amazon UK Marketpl,10.24,,14229.23,Amazon,Swansea,Uk
5947,5948,31/03/2016,DD,UNIV & COL UNION,22.37,,14239.47,Services,Swansea,Uk
5948,5949,31/03/2016,BGC,SWANSEA UNIVERSITY,,3126.88,14261.84,Supplementary Income,Swansea,Uk
5949,5950,30/03/2016,BP,SAVE THE CHANGE,2.14,,11134.96,Savings,Swansea,Uk
5950,5951,29/03/2016,DEB,Amazon UK Marketpl,27.89,,11137.1,Amazon,Swansea,Uk
5951,5952,29/03/2016,DEB,Amazon UK Marketpl,17.95,,11164.99,Amazon,Swansea,Uk
5952,5953,29/03/2016,DEB,Amazon UK Marketpl,16.17,,11182.94,Amazon,Swansea,Uk
5953,5954,29/03/2016,DEB,POST OFFICE COUNTE,14.5,,11199.11,Others,Swansea,Uk
5954,5955,29/03/2016,DEB,Amazon UK Marketpl,6.56,,11213.61,Amazon,Swansea,Uk
5955,5956,29/03/2016,DEB,Amazon UK Marketpl,5.79,,11220.17,Amazon,Swansea,Uk
5956,5957,29/03/2016,CPT,LOYD WALES UNIV SW,30.0,,11225.96,Cash,Swansea,Uk
5957,5958,24/03/2016,CPT,LOYD WALES UNIV SW,50.0,,11255.96,Cash,Swansea,Uk
5958,5959,24/03/2016,BP,SAVE THE CHANGE,0.2,,11305.96,Savings,Swansea,Uk
5959,5960,23/03/2016,DEB,ARRIVA TRAINS WALE,91.8,,11306.16,Travel,,
5960,5961,22/03/2016,DEB,Amazon UK Marketpl,18.0,,11397.96,Amazon,Swansea,Uk
5961,5962,22/03/2016,DD,CORGI HOMEPLAN CA,19.5,,11415.96,Home Improvement,Swansea,Uk
5962,5963,22/03/2016,BP,SAVE THE CHANGE,0.52,,11435.46,Savings,Swansea,Uk
5963,5964,21/03/2016,DEB,Amazon UK Retail,7.5,,11435.98,Amazon,Swansea,Uk
5964,5965,21/03/2016,DEB,Amazon UK Marketpl,4.98,,11443.48,Amazon,Swansea,Uk
5965,5966,21/03/2016,DD,VIRGIN MEDIA PYMTS,27.99,,11448.46,Bills,Nottingham,Uk
5966,5967,21/03/2016,BP,SAVE THE CHANGE,0.14,,11476.45,Savings,Swansea,Uk
5967,5968,18/03/2016,DEB,Amazon UK Marketpl,19.99,,11476.59,Amazon,Swansea,Uk
5968,5969,18/03/2016,DEB,Amazon UK Marketpl,2.87,,11496.58,Amazon,Swansea,Uk
5969,5970,18/03/2016,CPT,LOYD WALES UNIV SW,50.0,,11499.45,Cash,Swansea,Uk
5970,5971,18/03/2016,BP,SAVE THE CHANGE,2.0,,11549.45,Savings,Swansea,Uk
5971,5972,17/03/2016,DEB,Amazon Svcs Europe,17.24,,11551.45,Amazon,Swansea,Uk
5972,5973,17/03/2016,DEB,POST OFFICE COUNTE,14.5,,11568.69,Others,Swansea,Uk
5973,5974,17/03/2016,DEB,Amazon UK Marketpl,4.26,,11583.19,Amazon,Swansea,Uk
5974,5975,17/03/2016,BP,SAVE THE CHANGE,2.68,,11587.45,Savings,Swansea,Uk
5975,5976,16/03/2016,DEB,WWW.COLSTONHALL.OR,85.35,,11590.13,Travel,Bristol,Uk
5976,5977,16/03/2016,DEB,Amazon UK Retail,12.35,,11675.48,Amazon,Swansea,Uk
5977,5978,16/03/2016,DEB,Amazon UK Retail,11.99,,11687.83,Amazon,Swansea,Uk
5978,5979,16/03/2016,DEB,Amazon UK Marketpl,11.41,,11699.82,Amazon,Swansea,Uk
5979,5980,16/03/2016,DEB,Amazon Svcs Europe,10.22,,11711.23,Amazon,Swansea,Uk
5980,5981,16/03/2016,CPT,LOYD WALES UNIV SW,50.0,,11721.45,Cash,Swansea,Uk
5981,5982,16/03/2016,DD,O2,18.21,,11771.45,Other Shopping,Swansea,Uk
5982,5983,15/03/2016,BP,SAVE THE CHANGE,0.91,,11789.66,Savings,Swansea,Uk
5983,5984,14/03/2016,DEB,AMAZON MKTPLACE PM,26.85,,11790.57,Amazon,Swansea,Uk
5984,5985,14/03/2016,DEB,Amazon Svcs Europe,2.75,,11817.42,Amazon,Swansea,Uk
5985,5986,14/03/2016,DEB,NON-STG PURCH FEE,1.0,,11820.17,Others,Swansea,Uk
5986,5987,14/03/2016,DEB,NON-STG TRANS FEE,0.1,,11821.17,Others,Swansea,Uk
5987,5988,14/03/2016,DEB,RLR-CC.COM 1 88846,3.49,,11821.27,Others,Swansea,Uk
5988,5989,14/03/2016,BP,SAVE THE CHANGE,0.72,,11824.76,Savings,Swansea,Uk
5989,5990,14/03/2016,BGC,UNIOF WARWICK,,101.45,11825.48,Supplementary Income,Swansea,Uk
5990,5991,14/03/2016,DEB,NON-STG PURCH FEE,1.0,,11724.03,Others,Swansea,Uk
5991,5992,14/03/2016,DEB,NON-STG TRANS FEE,0.1,,11725.03,Others,Swansea,Uk
5992,5993,14/03/2016,DEB,ACTBLUE*BERNIE.SAN,3.54,,11725.13,Services,Swansea,Uk
5993,5994,11/03/2016,DEB,Amazon UK Marketpl,10.74,,11728.67,Amazon,Swansea,Uk
5994,5995,10/03/2016,CHQ,45,1100.0,,11739.41,Cash,,
5995,5996,09/03/2016,DEB,Amazon Prime,79.0,,12839.41,Amazon,Swansea,Uk
5996,5997,09/03/2016,DD,LV LIFE,37.12,,12918.41,Insurance,Swansea,Uk
5997,5998,09/03/2016,BP,SAVE THE CHANGE,0.58,,12955.53,Savings,Swansea,Uk
5998,5999,08/03/2016,DEB,AMAZON MKTPLACE PM,12.42,,12956.11,Amazon,Swansea,Uk
5999,6000,07/03/2016,BP,SAVE THE CHANGE,0.43,,12968.53,Savings,Swansea,Uk
6000,6001,04/03/2016,DEB,NON-STG PURCH FEE,1.0,,12968.96,Others,Swansea,Uk
6001,6002,04/03/2016,DEB,NON-STG TRANS FEE,0.1,,12969.96,Others,Swansea,Uk
6002,6003,04/03/2016,DEB,ACTBLUE*BERNIE.SAN,3.57,,12970.06,Services,Swansea,Uk
6003,6004,04/03/2016,CPT,LOYD WALES UNIV SW,50.0,,12973.63,Cash,Swansea,Uk
6004,6005,04/03/2016,BP,SAVE THE CHANGE,0.55,,13023.63,Savings,Swansea,Uk
6005,6006,03/03/2016,DEB,JS ONLINE GROCERY,241.45,,13024.18,Groceries,Swansea,Uk
6006,6007,03/03/2016,DD,ASSURANT INTER LTD,35.56,,13265.63,Insurance,Swansea,Uk
6007,6008,03/03/2016,BP,SAVE THE CHANGE,0.51,,13301.19,Savings,Swansea,Uk
6008,6009,02/03/2016,DEB,Amazon UK Retail,10.49,,13301.7,Amazon,Swansea,Uk
6009,6010,02/03/2016,TFR,F/FLOW UNIVERSITY,,907.92,13312.19,Supplementary Income,Swansea,Uk
6010,6011,02/03/2016,BP,SAVE THE CHANGE,0.05,,12404.27,Savings,Swansea,Uk
6011,6012,01/03/2016,FEE,ACCOUNT FEE,9.95,,12404.32,Bills,Swansea,Uk
6012,6013,01/03/2016,,INTEREST (NET),,4.74,12414.27,Interest,Swansea,Uk
6013,6014,01/03/2016,DEB,Amazon UK Marketpl,49.95,,12409.53,Amazon,Swansea,Uk
6014,6015,01/03/2016,DD,NATWEST BANK,828.49,,12459.48,Mortgage,Swansea,Uk
6015,6016,01/03/2016,DD,GOOD ENERGY GAS,43.0,,13287.97,Bills,Swansea,Uk
6016,6017,01/03/2016,DD,DWR CYMRU W WATER,14.5,,13330.97,Bills,Swansea,Uk
6017,6018,01/03/2016,DD,GOOD ENERGY LTD,13.0,,13345.47,Bills,Swansea,Uk
6018,6019,01/03/2016,DD,TV LICENCE MBP,12.12,,13358.47,Bills,Swansea,Uk
6019,6020,01/03/2016,SO,ESAVINGS ACCOUNT,300.0,,13370.59,Savings,Swansea,Uk
6020,6021,29/02/2016,DEB,IKEA ONLINE,98.0,,13670.59,Other Shopping,,
6021,6022,29/02/2016,DD,UNIV & COL UNION,22.37,,13768.59,Services,Swansea,Uk
6022,6023,29/02/2016,BGC,SWANSEA UNIVERSITY,,3127.28,13790.96,Supplementary Income,Swansea,Uk
6023,6024,26/02/2016,CPT,LOYD WALES UNIV SW,50.0,,10663.68,Cash,Swansea,Uk
6024,6025,26/02/2016,BGC,SWANSEA UNIVERSITY,,964.6,10713.68,Supplementary Income,Swansea,Uk
6025,6026,25/02/2016,CHQ,44,50.0,,9749.08,Cash,,
6026,6027,24/02/2016,BP,SAVE THE CHANGE,0.01,,9799.08,Savings,Swansea,Uk
6027,6028,23/02/2016,DEB,Amazon UK Retail,11.99,,9799.09,Amazon,Swansea,Uk
6028,6029,23/02/2016,CPT,LOYD WALES UNIV SW,40.0,,9811.08,Cash,Swansea,Uk
6029,6030,23/02/2016,FPO,A.MEADOWCROFT,65.0,,9851.08,Services,Swansea,Uk
6030,6031,23/02/2016,BP,SAVE THE CHANGE,0.56,,9916.08,Savings,Swansea,Uk
6031,6032,22/02/2016,DEB,Amazon UK Marketpl,37.69,,9916.64,Amazon,Swansea,Uk
6032,6033,22/02/2016,DEB,Amazon UK Retail,10.0,,9954.33,Amazon,Swansea,Uk
6033,6034,22/02/2016,DEB,Amazon UK Marketpl,4.75,,9964.33,Amazon,Swansea,Uk
6034,6035,22/02/2016,DD,VIRGIN MEDIA PYMTS,27.99,,9969.08,Bills,Nottingham,Uk
6035,6036,19/02/2016,CPT,LOYD WALES UNIV SW,30.0,,9997.07,Cash,Swansea,Uk
6036,6037,19/02/2016,BP,SAVE THE CHANGE,0.67,,10027.07,Savings,Swansea,Uk
6037,6038,18/02/2016,DEB,Amazon UK Marketpl,12.99,,10027.74,Amazon,Swansea,Uk
6038,6039,18/02/2016,DEB,Amazon UK Marketpl,1.34,,10040.73,Amazon,Swansea,Uk
6039,6040,18/02/2016,BP,SAVE THE CHANGE,1.35,,10042.07,Savings,Swansea,Uk
6040,6041,17/02/2016,DEB,ARRIVA TRAINS WALE,73.5,,10043.42,Travel,,
6041,6042,17/02/2016,DEB,Amazon UK Marketpl,21.16,,10116.92,Amazon,Swansea,Uk
6042,6043,17/02/2016,DEB,Amazon UK Marketpl,19.99,,10138.08,Amazon,Swansea,Uk
6043,6044,16/02/2016,CPT,LNK ARRIVA TRAINS,50.0,,10158.07,Cash,,
6044,6045,16/02/2016,DD,O2,18.92,,10208.07,Other Shopping,Swansea,Uk
6045,6046,16/02/2016,BP,SAVE THE CHANGE,0.92,,10226.99,Savings,Swansea,Uk
6046,6047,15/02/2016,DEB,Amazon UK Retail,21.09,,10227.91,Amazon,Swansea,Uk
6047,6048,15/02/2016,DEB,Amazon UK Retail,7.0,,10249.0,Amazon,Swansea,Uk
6048,6049,15/02/2016,DEB,Amazon UK Marketpl,3.99,,10256.0,Amazon,Swansea,Uk
6049,6050,15/02/2016,DEP,SWANSEA UNIVERSITY,,18.0,10259.99,Supplementary Income,Swansea,Uk
6050,6051,12/02/2016,CPT,LOYD WALES UNIV SW,20.0,,10241.99,Cash,Swansea,Uk
6051,6052,11/02/2016,CPT,LOYD WALES UNIV SW,40.0,,10261.99,Cash,Swansea,Uk
6052,6053,10/02/2016,BP,SAVE THE CHANGE,0.01,,10301.99,Savings,Swansea,Uk
6053,6054,09/02/2016,DEB,Amazon UK Retail,17.99,,10302.0,Amazon,Swansea,Uk
6054,6055,09/02/2016,DEB,Amazon UK Retail,5.0,,10319.99,Amazon,Swansea,Uk
6055,6056,08/02/2016,DD,LV LIFE,37.12,,10324.99,Insurance,Swansea,Uk
6056,6057,08/02/2016,FPO,A.MEADOWCROFT,90.0,,10362.11,Services,Swansea,Uk
6057,6058,05/02/2016,CPT,LOYD WALES UNIV SW,100.0,,10452.11,Cash,Swansea,Uk
6058,6059,04/02/2016,CPT,LOYD WALES UNIV SW,100.0,,10552.11,Cash,Swansea,Uk
6059,6060,04/02/2016,BP,SAVE THE CHANGE,0.25,,10652.11,Savings,Swansea,Uk
6060,6061,03/02/2016,DEB,Amazon UK Marketpl,8.75,,10652.36,Amazon,Swansea,Uk
6061,6062,03/02/2016,DD,ASSURANT INTER LTD,35.56,,10661.11,Insurance,Swansea,Uk
6062,6063,02/02/2016,CPT,LOYD WALES UNIV SW,50.0,,10696.67,Cash,Swansea,Uk
6063,6064,02/02/2016,BP,SAVE THE CHANGE,1.33,,10746.67,Savings,Swansea,Uk
6064,6065,01/02/2016,FEE,ACCOUNT FEE,9.95,,10748.0,Bills,Swansea,Uk
6065,6066,01/02/2016,,INTEREST (NET),,4.57,10757.95,Interest,Swansea,Uk
6066,6067,01/02/2016,DEB,Amazon UK Marketpl,26.55,,10753.38,Amazon,Swansea,Uk
6067,6068,01/02/2016,DEB,Amazon UK Marketpl,19.28,,10779.93,Amazon,Swansea,Uk
6068,6069,01/02/2016,DEB,Amazon UK Marketpl,9.84,,10799.21,Amazon,Swansea,Uk
6069,6070,01/02/2016,DD,NATWEST BANK,828.49,,10809.05,Mortgage,Swansea,Uk
6070,6071,01/02/2016,DD,CC SWANSEA C.TAX,122.0,,11637.54,Bills,Swansea,Uk
6071,6072,01/02/2016,DD,GOOD ENERGY GAS,43.0,,11759.54,Bills,Swansea,Uk
6072,6073,01/02/2016,DD,DWR CYMRU W WATER,14.5,,11802.54,Bills,Swansea,Uk
6073,6074,01/02/2016,DD,GOOD ENERGY LTD,13.0,,11817.04,Bills,Swansea,Uk
6074,6075,01/02/2016,DD,TV LICENCE MBP,12.12,,11830.04,Bills,Swansea,Uk
6075,6076,01/02/2016,SO,ESAVINGS ACCOUNT,300.0,,11842.16,Savings,Swansea,Uk
6076,6077,01/02/2016,BP,SAVE THE CHANGE,0.85,,12142.16,Savings,Swansea,Uk
6077,6078,29/01/2016,DEB,Amazon UK Marketpl,1.15,,12143.01,Amazon,Swansea,Uk
6078,6079,29/01/2016,CPT,LOYD WALES UNIV SW,50.0,,12144.16,Cash,Swansea,Uk
6079,6080,29/01/2016,DD,UNIV & COL UNION,22.37,,12194.16,Services,Swansea,Uk
6080,6081,29/01/2016,BGC,SWANSEA UNIVERSITY,,3126.88,12216.53,Supplementary Income,Swansea,Uk
6081,6082,27/01/2016,BP,SAVE THE CHANGE,1.32,,9089.65,Savings,Swansea,Uk
6082,6083,26/01/2016,DEB,Amazon UK Retail,17.17,,9090.97,Amazon,Swansea,Uk
6083,6084,26/01/2016,DEB,Amazon UK Marketpl,9.99,,9108.14,Amazon,Swansea,Uk
6084,6085,26/01/2016,DEB,Amazon UK Marketpl,7.98,,9118.13,Amazon,Swansea,Uk
6085,6086,26/01/2016,DEB,Amazon UK Marketpl,5.9,,9126.11,Amazon,Swansea,Uk
6086,6087,26/01/2016,DEB,Amazon UK Marketpl,3.64,,9132.01,Amazon,Swansea,Uk
6087,6088,26/01/2016,CPT,LOYD WALES UNIV SW,50.0,,9135.65,Cash,Swansea,Uk
6088,6089,25/01/2016,BP,SAVE THE CHANGE,0.39,,9185.65,Savings,Swansea,Uk
6089,6090,22/01/2016,DEB,NON-STG PURCH FEE,1.0,,9186.04,Others,Swansea,Uk
6090,6091,22/01/2016,DEB,NON-STG TRANS FEE,20.41,,9187.04,Others,Swansea,Uk
6091,6092,22/01/2016,DEB,HILTON HTL UNIV OF,682.61,,9207.45,Travel,,
6092,6093,21/01/2016,DD,VIRGIN MEDIA PYMTS,16.91,,9890.06,Bills,Nottingham,Uk
6093,6094,21/01/2016,DEB,NON-STG CASH FEE,2.0,,9906.97,Others,Swansea,Uk
6094,6095,21/01/2016,DEB,NON-STG TRANS FEE,2.16,,9908.97,Others,Swansea,Uk
6095,6096,21/01/2016,DEB,*UNIVERSITY OF HOU,72.51,,9911.13,Travel,Houston,Usa
6096,6097,20/01/2016,BP,SAVE THE CHANGE,0.55,,9983.64,Savings,Swansea,Uk
6097,6098,19/01/2016,DEB,NON-STG PURCH FEE,1.0,,9984.19,Others,Swansea,Uk
6098,6099,19/01/2016,DEB,NON-STG TRANS FEE,0.52,,9985.19,Others,Swansea,Uk
6099,6100,19/01/2016,DEB,UNITED  016260,17.45,,9985.71,Travel,,
6100,6101,19/01/2016,BP,SAVE THE CHANGE,0.8,,10003.16,Savings,Swansea,Uk
6101,6102,18/01/2016,DEB,NON-STG PURCH FEE,1.0,,10003.96,Others,Swansea,Uk
6102,6103,18/01/2016,DEB,NON-STG TRANS FEE,4.55,,10004.96,Others,Swansea,Uk
6103,6104,18/01/2016,DEB,HOLIDAY INN HOUSTO,152.2,,10009.51,Hotels,,
6104,6105,18/01/2016,DD,O2,16.62,,10161.71,Other Shopping,Swansea,Uk
6105,6106,12/01/2016,BP,SAVE THE CHANGE,1.94,,10178.33,Savings,Swansea,Uk
6106,6107,11/01/2016,DEB,NON-STG PURCH FEE,1.0,,10180.27,Others,Swansea,Uk
6107,6108,11/01/2016,DEB,NON-STG TRANS FEE,0.55,,10181.27,Others,Swansea,Uk
6108,6109,11/01/2016,DEB,HOUSTON GEORGE BUS,18.59,,10181.82,Travel,Huston,Usa
6109,6110,11/01/2016,DEB,NON-STG PURCH FEE,1.0,,10200.41,Others,Swansea,Uk
6110,6111,11/01/2016,DEB,NON-STG TRANS FEE,0.51,,10201.41,Others,Swansea,Uk
6111,6112,11/01/2016,DEB,UNITED  016260,17.18,,10201.92,Travel,,
6112,6113,11/01/2016,DEB,Amazon UK Marketpl,14.29,,10219.1,Amazon,Swansea,Uk
6113,6114,11/01/2016,BP,SAVE THE CHANGE,0.16,,10233.39,Savings,Swansea,Uk
6114,6115,08/01/2016,DEB,Amazon UK Retail,34.99,,10233.55,Amazon,Swansea,Uk
6115,6116,08/01/2016,DEB,Amazon UK Marketpl,7.85,,10268.54,Amazon,Swansea,Uk
6116,6117,08/01/2016,CPT,LOYD WALES UNIV SW,40.0,,10276.39,Cash,Swansea,Uk
6117,6118,08/01/2016,DD,LV LIFE,37.12,,10316.39,Insurance,Swansea,Uk
6118,6119,08/01/2016,BP,SAVE THE CHANGE,1.2,,10353.51,Savings,Swansea,Uk
6119,6120,07/01/2016,DEB,JS ONLINE GROCERY,231.6,,10354.71,Groceries,Swansea,Uk
6120,6121,07/01/2016,DEB,AMAZON MKTPLACE PM,16.2,,10586.31,Amazon,Swansea,Uk
6121,6122,07/01/2016,CPT,LOYD WALES UNIV SW,100.0,,10602.51,Cash,Swansea,Uk
6122,6123,07/01/2016,BP,SAVE THE CHANGE,0.77,,10702.51,Savings,Swansea,Uk
6123,6124,06/01/2016,DEB,Amazon UK Marketpl,11.75,,10703.28,Amazon,Swansea,Uk
6124,6125,06/01/2016,DEB,Amazon UK Marketpl,5.5,,10715.03,Amazon,Swansea,Uk
6125,6126,06/01/2016,DEB,Amazon UK Marketpl,3.98,,10720.53,Amazon,Swansea,Uk
6126,6127,05/01/2016,CPT,LOYD WALES UNIV SW,100.0,,10724.51,Cash,Swansea,Uk
6127,6128,05/01/2016,BP,SAVE THE CHANGE,0.15,,10824.51,Savings,Swansea,Uk
6128,6129,04/01/2016,FEE,ACCOUNT FEE,9.95,,10824.66,Bills,Swansea,Uk
6129,6130,04/01/2016,,INTEREST (NET),,5.56,10834.61,Interest,Swansea,Uk
6130,6131,04/01/2016,DEB,Amazon UK Retail,8.99,,10829.05,Amazon,Swansea,Uk
6131,6132,04/01/2016,DEB,Amazon UK Marketpl,1.86,,10838.04,Amazon,Swansea,Uk
6132,6133,04/01/2016,DD,NATWEST BANK,828.49,,10839.9,Mortgage,Swansea,Uk
6133,6134,04/01/2016,DD,CC SWANSEA C.TAX,122.0,,11668.39,Bills,Swansea,Uk
6134,6135,04/01/2016,DD,GOOD ENERGY GAS,43.0,,11790.39,Bills,Swansea,Uk
6135,6136,04/01/2016,DD,ASSURANT INTER LTD,35.56,,11833.39,Insurance,Swansea,Uk
6136,6137,04/01/2016,DD,DWR CYMRU W WATER,14.5,,11868.95,Bills,Swansea,Uk
6137,6138,04/01/2016,DD,GOOD ENERGY LTD,13.0,,11883.45,Bills,Swansea,Uk
6138,6139,04/01/2016,DD,TV LICENCE MBP,12.12,,11896.45,Bills,Swansea,Uk
6139,6140,04/01/2016,SO,ESAVINGS ACCOUNT,300.0,,11908.57,Savings,Swansea,Uk
6140,6141,04/01/2016,BP,SAVE THE CHANGE,1.97,,12208.57,Savings,Swansea,Uk
6141,6142,04/01/2016,CPT,LNK THE COOPERATIV,40.0,,12210.54,Cash,,
6142,6143,31/12/2015,DEB,Amazon UK Retail,26.93,,12250.54,Amazon,Swansea,Uk
6143,6144,31/12/2015,DEB,Amazon UK Retail,8.97,,12277.47,Amazon,Swansea,Uk
6144,6145,31/12/2015,DEB,Amazon UK Marketpl,8.36,,12286.44,Amazon,Swansea,Uk
6145,6146,31/12/2015,DEB,Amazon UK Marketpl,2.55,,12294.8,Amazon,Swansea,Uk
6146,6147,31/12/2015,DEB,PAYPAL *CARL DAVIE,47.22,,12297.35,Services,Swansea,Uk
6147,6148,31/12/2015,DD,UNIV & COL UNION,22.37,,12344.57,Services,Swansea,Uk
6148,6149,31/12/2015,BP,SAVE THE CHANGE,3.39,,12366.94,Savings,Swansea,Uk
6149,6150,30/12/2015,DEB,LUSH RETAIL LTD,47.29,,12370.33,Other Shopping,,
6150,6151,30/12/2015,DEB,SPORTSDIRECT 141,19.99,,12417.62,Other Shopping,,
6151,6152,30/12/2015,DEB,EXOTICA,13.14,,12437.61,Groceries,Swansea,Uk
6152,6153,30/12/2015,DEB,Amazon UK Marketpl,6.2,,12450.75,Amazon,Swansea,Uk
6153,6154,30/12/2015,DEB,Amazon UK Marketpl,4.98,,12456.95,Amazon,Swansea,Uk
6154,6155,30/12/2015,DEB,Amazon Svcs Europe,3.94,,12461.93,Amazon,Swansea,Uk
6155,6156,30/12/2015,DEB,Amazon Svcs Europe,2.07,,12465.87,Amazon,Swansea,Uk
6156,6157,30/12/2015,BP,SAVE THE CHANGE,0.21,,12467.94,Savings,Swansea,Uk
6157,6158,29/12/2015,DEB,Amazon UK Marketpl,117.99,,12468.15,Amazon,Swansea,Uk
6158,6159,29/12/2015,DEB,SAINSBURYS - SWANS,22.85,,12586.14,Groceries,Swansea,Uk
6159,6160,29/12/2015,DEB,Amazon UK Marketpl,32.95,,12608.99,Amazon,Swansea,Uk
6160,6161,29/12/2015,DEB,CO-OP GROUP FOOD,19.0,,12641.94,Groceries,,
6161,6162,29/12/2015,DEB,Amazon UK Retail,12.0,,12660.94,Amazon,Swansea,Uk
6162,6163,24/12/2015,BP,SAVE THE CHANGE,0.13,,12672.94,Savings,Swansea,Uk
6163,6164,24/12/2015,BGC,SWANSEA UNIVERSITY,,1612.63,12673.07,Supplementary Income,Swansea,Uk
6164,6165,23/12/2015,DEB,Amazon UK Marketpl,1.87,,11060.44,Amazon,Swansea,Uk
6165,6166,23/12/2015,BP,SAVE THE CHANGE,0.8,,11062.31,Savings,Swansea,Uk
6166,6167,22/12/2015,DEB,Amazon UK Marketpl,9.2,,11063.11,Amazon,Swansea,Uk
6167,6168,22/12/2015,CPT,LOYD WALES UNIV SW,50.0,,11072.31,Cash,Swansea,Uk
6168,6169,22/12/2015,BP,SAVE THE CHANGE,1.54,,11122.31,Savings,Swansea,Uk
6169,6170,21/12/2015,DEB,ODEON/BOOKIT,26.0,,11123.85,Entertainment,,
6170,6171,21/12/2015,DEB,Amazon UK Marketpl,17.99,,11149.85,Amazon,Swansea,Uk
6171,6172,21/12/2015,DEB,UNITED AIR  016936,117.7,,11167.84,Travel,,
6172,6173,21/12/2015,DEB,Amazon UK Marketpl,29.68,,11285.54,Amazon,Swansea,Uk
6173,6174,21/12/2015,DEB,GODADDY COM EUROPE,12.2,,11315.22,Others,Swansea,Uk
6174,6175,21/12/2015,DEB,EXPEDIA 1104152727,10.0,,11327.42,Travel,,
6175,6176,21/12/2015,DEB,Amazon UK Marketpl,6.97,,11337.42,Amazon,Swansea,Uk
6176,6177,21/12/2015,DEB,Amazon UK Marketpl,1.92,,11344.39,Amazon,Swansea,Uk
6177,6178,21/12/2015,DD,VIRGIN MEDIA PYMTS,37.78,,11346.31,Bills,Nottingham,Uk
6178,6179,21/12/2015,BP,SAVE THE CHANGE,1.65,,11384.09,Savings,Swansea,Uk
6179,6180,21/12/2015,BGC,SWANSEA UNIVERSITY,,3127.28,11385.74,Supplementary Income,Swansea,Uk
6180,6181,18/12/2015,DEB,Amazon UK Marketpl,4.28,,8258.46,Amazon,Swansea,Uk
6181,6182,18/12/2015,DEB,Amazon UK Marketpl,1.07,,8262.74,Amazon,Swansea,Uk
6182,6183,17/12/2015,BP,SAVE THE CHANGE,0.01,,8263.81,Savings,Swansea,Uk
6183,6184,16/12/2015,DEB,Amazon UK Marketpl,9.99,,8263.82,Amazon,Swansea,Uk
6184,6185,16/12/2015,CPT,LOYD WALES UNIV SW,40.0,,8273.81,Cash,Swansea,Uk
6185,6186,16/12/2015,DD,O2,17.42,,8313.81,Other Shopping,Swansea,Uk
6186,6187,16/12/2015,BP,SAVE THE CHANGE,0.11,,8331.23,Savings,Swansea,Uk
6187,6188,15/12/2015,DEB,PUB ON THE POND,28.99,,8331.34,Dine Out,Swansea,Uk
6188,6189,15/12/2015,DEB,Amazon UK Marketpl,13.9,,8360.33,Amazon,Swansea,Uk
6189,6190,15/12/2015,CPT,LOYD WALES UNIV SW,50.0,,8374.23,Cash,Swansea,Uk
6190,6191,15/12/2015,BP,SAVE THE CHANGE,0.15,,8424.23,Savings,Swansea,Uk
6191,6192,14/12/2015,DEB,Amazon UK Retail,21.99,,8424.38,Amazon,Swansea,Uk
6192,6193,14/12/2015,DEB,Amazon Svcs Europe,5.98,,8446.37,Amazon,Swansea,Uk
6193,6194,14/12/2015,DEB,Amazon UK Marketpl,7.88,,8452.35,Amazon,Swansea,Uk
6194,6195,14/12/2015,DEB,WIKIMEDIA,2.0,,8460.23,Others,Swansea,Uk
6195,6196,14/12/2015,BP,SAVE THE CHANGE,0.64,,8462.23,Savings,Swansea,Uk
6196,6197,11/12/2015,DEB,Amazon UK Retail,119.99,,8462.87,Amazon,Swansea,Uk
6197,6198,11/12/2015,DEB,SUSU TRADING LTD,44.53,,8582.86,Home Improvement,Swansea,Uk
6198,6199,11/12/2015,DEB,Amazon UK Marketpl,14.85,,8627.39,Amazon,Swansea,Uk
6199,6200,11/12/2015,DEB,Amazon UK Retail,3.99,,8642.24,Amazon,Swansea,Uk
6200,6201,10/12/2015,CHQ,43,200.0,,8646.23,Cash,,
6201,6202,10/12/2015,BP,SAVE THE CHANGE,1.29,,8846.23,Savings,Swansea,Uk
6202,6203,09/12/2015,DEB,AMAZON MKTPLACE PM,10.74,,8847.52,Amazon,Swansea,Uk
6203,6204,09/12/2015,DEB,Amazon UK Marketpl,4.7,,8858.26,Amazon,Swansea,Uk
6204,6205,09/12/2015,DEB,Amazon UK Marketpl,2.27,,8862.96,Amazon,Swansea,Uk
6205,6206,09/12/2015,DEB,SKYPE SUBSCRIPTION,10.0,,8865.23,Bills,Swansea,Uk
6206,6207,09/12/2015,DD,LV LIFE,37.12,,8875.23,Insurance,Swansea,Uk
6207,6208,08/12/2015,BP,SAVE THE CHANGE,2.17,,8912.35,Savings,Swansea,Uk
6208,6209,07/12/2015,DEB,Amazon UK Marketpl,23.99,,8914.52,Amazon,Swansea,Uk
6209,6210,07/12/2015,DEB,Amazon UK Retail,13.36,,8938.51,Amazon,Swansea,Uk
6210,6211,07/12/2015,DEB,Amazon UK Retail,11.99,,8951.87,Amazon,Swansea,Uk
6211,6212,07/12/2015,DEB,Amazon UK Retail,3.87,,8963.86,Amazon,Swansea,Uk
6212,6213,07/12/2015,DEB,NON-STG PURCH FEE,1.0,,8967.73,Others,Swansea,Uk
6213,6214,07/12/2015,DEB,NON-STG TRANS FEE,6.23,,8968.73,Others,Swansea,Uk
6214,6215,07/12/2015,DEB,ACTIVATORME,208.38,,8974.96,Other Shopping,Swansea,Uk
6215,6216,07/12/2015,DEB,Amazon UK Marketpl,9.24,,9183.34,Amazon,Swansea,Uk
6216,6217,07/12/2015,BP,SAVE THE CHANGE,1.23,,9192.58,Savings,Swansea,Uk
6217,6218,04/12/2015,DEB,Amazon UK Marketpl,7.74,,9193.81,Amazon,Swansea,Uk
6218,6219,04/12/2015,DEB,Amazon UK Marketpl,2.03,,9201.55,Amazon,Swansea,Uk
6219,6220,04/12/2015,BP,SAVE THE CHANGE,0.8,,9203.58,Savings,Swansea,Uk
6220,6221,03/12/2015,DEB,JS ONLINE GROCERY,266.6,,9204.38,Groceries,Swansea,Uk
6221,6222,03/12/2015,DEB,Amazon UK Marketpl,4.6,,9470.98,Amazon,Swansea,Uk
6222,6223,03/12/2015,DD,ASSURANT INTER LTD,35.56,,9475.58,Insurance,Swansea,Uk
6223,6224,03/12/2015,BP,SAVE THE CHANGE,0.17,,9511.14,Savings,Swansea,Uk
6224,6225,02/12/2015,DEB,Amazon UK Marketpl,10.83,,9511.31,Amazon,Swansea,Uk
6225,6226,02/12/2015,BP,SAVE THE CHANGE,1.15,,9522.14,Savings,Swansea,Uk
6226,6227,01/12/2015,FEE,ACCOUNT FEE,9.95,,9523.29,Bills,Swansea,Uk
6227,6228,01/12/2015,,INTEREST (NET),,4.74,9533.24,Interest,Swansea,Uk
6228,6229,01/12/2015,DEB,Amazon Svcs Europe,6.6,,9528.5,Amazon,Swansea,Uk
6229,6230,01/12/2015,DEB,Amazon UK Marketpl,2.25,,9535.1,Amazon,Swansea,Uk
6230,6231,01/12/2015,DD,NATWEST BANK,828.49,,9537.35,Mortgage,Swansea,Uk
6231,6232,01/12/2015,DD,CC SWANSEA C.TAX,122.0,,10365.84,Bills,Swansea,Uk
6232,6233,01/12/2015,DD,GOOD ENERGY GAS,43.0,,10487.84,Bills,Swansea,Uk
6233,6234,01/12/2015,DD,DWR CYMRU W WATER,14.5,,10530.84,Bills,Swansea,Uk
6234,6235,01/12/2015,DD,GOOD ENERGY LTD,13.0,,10545.34,Bills,Swansea,Uk
6235,6236,01/12/2015,DD,TV LICENCE MBP,12.18,,10558.34,Bills,Swansea,Uk
6236,6237,01/12/2015,SO,ESAVINGS ACCOUNT,300.0,,10570.52,Savings,Swansea,Uk
6237,6238,01/12/2015,BP,SAVE THE CHANGE,1.34,,10870.52,Savings,Swansea,Uk
6238,6239,30/11/2015,DEB,Amazon UK Marketpl,11.99,,10871.86,Amazon,Swansea,Uk
6239,6240,30/11/2015,DEB,Amazon UK Marketpl,6.95,,10883.85,Amazon,Swansea,Uk
6240,6241,30/11/2015,DEB,Amazon UK Retail,5.49,,10890.8,Amazon,Swansea,Uk
6241,6242,30/11/2015,DEB,Amazon UK Marketpl,2.99,,10896.29,Amazon,Swansea,Uk
6242,6243,30/11/2015,DEB,Amazon UK Marketpl,2.24,,10899.28,Amazon,Swansea,Uk
6243,6244,30/11/2015,DD,UNIV & COL UNION,22.37,,10901.52,Services,Swansea,Uk
6244,6245,30/11/2015,BP,SAVE THE CHANGE,0.75,,10923.89,Savings,Swansea,Uk
6245,6246,30/11/2015,BGC,SWANSEA UNIVERSITY,,3199.54,10924.64,Supplementary Income,Swansea,Uk
6246,6247,27/11/2015,DEB,SAINSBURYS - SWANS,12.25,,7725.1,Groceries,Swansea,Uk
6247,6248,26/11/2015,CPT,SBY  SWANSEA UPL C,50.0,,7737.35,Other Shopping,Swansea,Uk
6248,6249,26/11/2015,BP,SAVE THE CHANGE,0.52,,7787.35,Savings,Swansea,Uk
6249,6250,25/11/2015,DEB,Amazon UK Marketpl,22.54,,7787.87,Amazon,Swansea,Uk
6250,6251,25/11/2015,DEB,Amazon UK Marketpl,1.94,,7810.41,Amazon,Swansea,Uk
6251,6252,25/11/2015,CPT,LOYD WALES UNIV SW,50.0,,7812.35,Cash,Swansea,Uk
6252,6253,25/11/2015,BP,SAVE THE CHANGE,2.71,,7862.35,Savings,Swansea,Uk
6253,6254,24/11/2015,DEB,Amazon UK Retail,7.99,,7865.06,Amazon,Swansea,Uk
6254,6255,24/11/2015,DEB,Amazon UK Marketpl,7.39,,7873.05,Amazon,Swansea,Uk
6255,6256,24/11/2015,DEB,Amazon UK Marketpl,6.59,,7880.44,Amazon,Swansea,Uk
6256,6257,24/11/2015,DEB,Amazon UK Marketpl,2.25,,7887.03,Amazon,Swansea,Uk
6257,6258,24/11/2015,DEB,Amazon UK Marketpl,1.07,,7889.28,Amazon,Swansea,Uk
6258,6259,24/11/2015,BP,SAVE THE CHANGE,2.31,,7890.35,Savings,Swansea,Uk
6259,6260,23/11/2015,DEB,Amazon UK Retail,16.11,,7892.66,Amazon,Swansea,Uk
6260,6261,23/11/2015,DEB,Amazon UK Retail,7.49,,7908.77,Amazon,Swansea,Uk
6261,6262,23/11/2015,DEB,Amazon UK Marketpl,30.27,,7916.26,Amazon,Swansea,Uk
6262,6263,23/11/2015,DEB,Amazon UK Marketpl,6.89,,7946.53,Amazon,Swansea,Uk
6263,6264,23/11/2015,DEB,Amazon UK Marketpl,2.93,,7953.42,Amazon,Swansea,Uk
6264,6265,23/11/2015,DD,VIRGIN MEDIA PYMTS,37.78,,7956.35,Bills,Nottingham,Uk
6265,6266,20/11/2015,BP,SAVE THE CHANGE,0.9,,7994.13,Savings,Swansea,Uk
6266,6267,19/11/2015,DEB,GWR STOKE GIFF SST,26.1,,7995.03,Travel,Bristol,Uk
6267,6268,19/11/2015,BP,SAVE THE CHANGE,1.7,,8021.13,Savings,Swansea,Uk
6268,6269,18/11/2015,DEB,IZ *Friska Ltd,5.25,,8022.83,Dine Out,Bristol,Uk
6269,6270,18/11/2015,DEB,PREMIER INN4401262,109.05,,8028.08,Hotels,,
6270,6271,18/11/2015,DEB,CLKBANK*COM_REFUND,,39.62,8137.13,Supplementary Income,Swansea,Uk
6271,6272,17/11/2015,CPT,LNK UNION STREET,20.0,,8097.51,Cash,,
6272,6273,17/11/2015,BP,SAVE THE CHANGE,2.95,,8117.51,Savings,Swansea,Uk
6273,6274,16/11/2015,DEB,Amazon UK Marketpl,13.64,,8120.46,Amazon,Swansea,Uk
6274,6275,16/11/2015,DEB,Amazon UK Retail,4.72,,8134.1,Amazon,Swansea,Uk
6275,6276,16/11/2015,DEB,Amazon UK Marketpl,2.02,,8138.82,Amazon,Swansea,Uk
6276,6277,16/11/2015,DEB,Amazon UK Marketpl,0.82,,8140.84,Amazon,Swansea,Uk
6277,6278,16/11/2015,DEB,Amazon UK Retail,27.46,,8141.66,Amazon,Swansea,Uk
6278,6279,16/11/2015,DEB,Amazon UK Marketpl,3.39,,8169.12,Amazon,Swansea,Uk
6279,6280,16/11/2015,DD,O2,19.02,,8172.51,Other Shopping,Swansea,Uk
6280,6281,13/11/2015,BP,SAVE THE CHANGE,0.85,,8191.53,Savings,Swansea,Uk
6281,6282,12/11/2015,DEB,Amazon UK Marketpl,11.95,,8192.38,Amazon,Swansea,Uk
6282,6283,12/11/2015,DEB,Amazon UK Retail,5.2,,8204.33,Amazon,Swansea,Uk
6283,6284,12/11/2015,BP,SAVE THE CHANGE,0.61,,8209.53,Savings,Swansea,Uk
6284,6285,11/11/2015,DEB,Amazon UK Retail,8.39,,8210.14,Amazon,Swansea,Uk
6285,6286,11/11/2015,BP,SAVE THE CHANGE,0.62,,8218.53,Savings,Swansea,Uk
6286,6287,10/11/2015,DEB,Amazon UK Retail,35.38,,8219.15,Amazon,Swansea,Uk
6287,6288,10/11/2015,BP,SAVE THE CHANGE,0.04,,8254.53,Savings,Swansea,Uk
6288,6289,09/11/2015,DEB,Amazon UK Marketpl,20.97,,8254.57,Amazon,Swansea,Uk
6289,6290,09/11/2015,DEB,Amazon UK Marketpl,4.99,,8275.54,Amazon,Swansea,Uk
6290,6291,09/11/2015,DD,LV LIFE,37.12,,8280.53,Insurance,Swansea,Uk
6291,6292,09/11/2015,BP,SAVE THE CHANGE,0.99,,8317.65,Savings,Swansea,Uk
6292,6293,06/11/2015,DEB,Amazon UK Marketpl,4.01,,8318.64,Amazon,Swansea,Uk
6293,6294,06/11/2015,BP,SAVE THE CHANGE,0.72,,8322.65,Savings,Swansea,Uk
6294,6295,05/11/2015,DEB,Amazon UK Marketpl,12.99,,8323.37,Amazon,Swansea,Uk
6295,6296,05/11/2015,DEB,Amazon UK Retail,9.29,,8336.36,Amazon,Swansea,Uk
6296,6297,05/11/2015,BP,SAVE THE CHANGE,1.32,,8345.65,Savings,Swansea,Uk
6297,6298,04/11/2015,DEB,Amazon UK Marketpl,9.59,,8346.97,Amazon,Swansea,Uk
6298,6299,04/11/2015,DEB,Amazon UK Marketpl,4.09,,8356.56,Amazon,Swansea,Uk
6299,6300,04/11/2015,BP,SAVE THE CHANGE,1.38,,8360.65,Savings,Swansea,Uk
6300,6301,03/11/2015,DEB,Amazon UK Marketpl,57.47,,8362.03,Amazon,Swansea,Uk
6301,6302,03/11/2015,DEB,Amazon UK Retail,12.39,,8419.5,Amazon,Swansea,Uk
6302,6303,03/11/2015,DD,ASSURANT INTER LTD,35.56,,8431.89,Insurance,Swansea,Uk
6303,6304,03/11/2015,DEB,NON-STG PURCH FEE,1.0,,8467.45,Others,Swansea,Uk
6304,6305,03/11/2015,DEB,NON-STG TRANS FEE,27.2,,8468.45,Others,Swansea,Uk
6305,6306,03/11/2015,DEB,HILTON HOTELS PALM,909.76,,8495.65,Hotels,,
6306,6307,03/11/2015,BP,SAVE THE CHANGE,0.46,,9405.41,Savings,Swansea,Uk
6307,6308,02/11/2015,FEE,ACCOUNT FEE,9.95,,9405.87,Bills,Swansea,Uk
6308,6309,02/11/2015,,INTEREST (NET),,5.23,9415.82,Interest,Swansea,Uk
6309,6310,02/11/2015,DEB,Amazon UK Marketpl,1.59,,9410.59,Amazon,Swansea,Uk
6310,6311,02/11/2015,DEB,Amazon UK Marketpl,3.95,,9412.18,Amazon,Swansea,Uk
6311,6312,02/11/2015,DD,NATWEST BANK,748.13,,9416.13,Mortgage,Swansea,Uk
6312,6313,02/11/2015,DD,GOOD ENERGY GAS,43.0,,10164.26,Bills,Swansea,Uk
6313,6314,02/11/2015,DD,DWR CYMRU W WATER,14.5,,10207.26,Bills,Swansea,Uk
6314,6315,02/11/2015,DD,GOOD ENERGY LTD,13.0,,10221.76,Bills,Swansea,Uk
6315,6316,02/11/2015,DD,TV LICENCE MBP,12.12,,10234.76,Bills,Swansea,Uk
6316,6317,02/11/2015,SO,ESAVINGS ACCOUNT,300.0,,10246.88,Savings,Swansea,Uk
6317,6318,02/11/2015,BP,SAVE THE CHANGE,1.14,,10546.88,Savings,Swansea,Uk
6318,6319,30/10/2015,DD,UNIV & COL UNION,22.37,,10548.02,Services,Swansea,Uk
6319,6320,30/10/2015,DEB,NON-STG CASH FEE,2.0,,10570.39,Others,Swansea,Uk
6320,6321,30/10/2015,DEB,NON-STG TRANS FEE,3.91,,10572.39,Others,Swansea,Uk
6321,6322,30/10/2015,DEB,17 E MONROE ST LBB,130.94,,10576.3,Services,Swansea,Uk
6322,6323,30/10/2015,DEB,NON-STG PURCH FEE,1.0,,10707.24,Others,Swansea,Uk
6323,6324,30/10/2015,DEB,NON-STG TRANS FEE,0.74,,10708.24,Others,Swansea,Uk
6324,6325,30/10/2015,DEB,FEELINGS GIFT SHOP,25.03,,10708.98,Other Shopping,,
6325,6326,30/10/2015,DEB,NON-STG PURCH FEE,1.0,,10734.01,Others,Swansea,Uk
6326,6327,30/10/2015,DEB,NON-STG TRANS FEE,0.32,,10735.01,Others,Swansea,Uk
6327,6328,30/10/2015,DEB,FRESHII - 653,10.83,,10735.33,Dine Out,,
6328,6329,30/10/2015,BP,SAVE THE CHANGE,0.18,,10746.16,Savings,Swansea,Uk
6329,6330,30/10/2015,BGC,SWANSEA UNIVERSITY,,3064.27,10746.34,Supplementary Income,Swansea,Uk
6330,6331,29/10/2015,DEB,NON-STG PURCH FEE,1.0,,7682.07,Others,Swansea,Uk
6331,6332,29/10/2015,DEB,NON-STG TRANS FEE,3.1,,7683.07,Others,Swansea,Uk
6332,6333,29/10/2015,DEB,SKECHERS-USA #229,103.82,,7686.17,Other Shopping,,
6333,6334,29/10/2015,BP,SAVE THE CHANGE,0.35,,7789.99,Savings,Swansea,Uk
6334,6335,28/10/2015,DEB,NON-STG PURCH FEE,1.0,,7790.34,Others,Swansea,Uk
6335,6336,28/10/2015,DEB,NON-STG TRANS FEE,0.88,,7791.34,Others,Swansea,Uk
6336,6337,28/10/2015,DEB,ITALIAN VILLAGE,29.65,,7792.22,Dine Out,,
6337,6338,28/10/2015,BP,SAVE THE CHANGE,0.01,,7821.87,Savings,Swansea,Uk
6338,6339,27/10/2015,DEB,CITY FLOWERS,9.99,,7821.88,Other Shopping,Nottingham,Uk
6339,6340,27/10/2015,BP,SAVE THE CHANGE,0.26,,7831.87,Savings,Swansea,Uk
6340,6341,26/10/2015,DEB,NON-STG PURCH FEE,1.0,,7832.13,Others,Swansea,Uk
6341,6342,26/10/2015,DEB,NON-STG TRANS FEE,4.5,,7833.13,Others,Swansea,Uk
6342,6343,26/10/2015,DEB,HILTON HOTELS PALM,150.74,,7837.63,Hotels,,
6343,6344,26/10/2015,BP,SAVE THE CHANGE,0.6,,7988.37,Savings,Swansea,Uk
6344,6345,23/10/2015,DEB,SUSU TRADING LTD,59.4,,7988.97,Home Improvement,Swansea,Uk
6345,6346,22/10/2015,CPT,LNK FULTON HOUSE,142.86,,8048.37,Cash,Swansea,Uk
6346,6347,22/10/2015,CPT,LOYD WALES UNIV SW,150.0,,8191.23,Cash,Swansea,Uk
6347,6348,22/10/2015,BP,SAVE THE CHANGE,0.95,,8341.23,Savings,Swansea,Uk
6348,6349,21/10/2015,DEB,Amazon UK Marketpl,5.05,,8342.18,Amazon,Swansea,Uk
6349,6350,21/10/2015,DD,VIRGIN MEDIA PYMTS,37.78,,8347.23,Bills,Nottingham,Uk
6350,6351,21/10/2015,BP,SAVE THE CHANGE,0.05,,8385.01,Savings,Swansea,Uk
6351,6352,20/10/2015,DEB,Amazon UK Marketpl,3.95,,8385.06,Amazon,Swansea,Uk
6352,6353,20/10/2015,BP,SAVE THE CHANGE,0.33,,8389.01,Savings,Swansea,Uk
6353,6354,19/10/2015,DEB,JS ONLINE GROCERY,242.7,,8389.34,Groceries,Swansea,Uk
6354,6355,19/10/2015,DEB,Amazon UK Marketpl,6.97,,8632.04,Amazon,Swansea,Uk
6355,6356,19/10/2015,DEB,JS ONLINE GROCERY,,4.4,8639.01,Supplementary Income,Swansea,Uk
6356,6357,16/10/2015,CPT,LOYD WALES UNIV SW,50.0,,8634.61,Cash,Swansea,Uk
6357,6358,16/10/2015,DD,O2,32.55,,8684.61,Other Shopping,Swansea,Uk
6358,6359,16/10/2015,BP,SAVE THE CHANGE,0.05,,8717.16,Savings,Swansea,Uk
6359,6360,15/10/2015,DEB,Amazon UK Marketpl,24.95,,8717.21,Amazon,Swansea,Uk
6360,6361,15/10/2015,BP,SAVE THE CHANGE,0.1,,8742.16,Savings,Swansea,Uk
6361,6362,14/10/2015,DEB,Amazon UK Marketpl,9.9,,8742.26,Amazon,Swansea,Uk
6362,6363,14/10/2015,BP,SAVE THE CHANGE,0.57,,8752.16,Savings,Swansea,Uk
6363,6364,13/10/2015,DEB,Amazon UK Marketpl,11.95,,8752.73,Amazon,Swansea,Uk
6364,6365,13/10/2015,DEB,Amazon UK Marketpl,4.48,,8764.68,Amazon,Swansea,Uk
6365,6366,13/10/2015,BP,SAVE THE CHANGE,0.32,,8769.16,Savings,Swansea,Uk
6366,6367,12/10/2015,DEB,CLKBANK*COM_YS2DQ7,16.68,,8769.48,,,
6367,6368,12/10/2015,BP,SAVE THE CHANGE,0.21,,8786.16,Savings,Swansea,Uk
6368,6369,09/10/2015,DEB,Amazon UK Marketpl,6.79,,8786.37,Amazon,Swansea,Uk
6369,6370,09/10/2015,DD,LV LIFE,37.12,,8793.16,Insurance,Swansea,Uk
6370,6371,09/10/2015,BP,SAVE THE CHANGE,0.63,,8830.28,Savings,Swansea,Uk
6371,6372,08/10/2015,DEB,Amazon Svcs Europe,17.4,,8830.91,Amazon,,
6372,6373,08/10/2015,DEB,Amazon UK Retail,8.97,,8848.31,Amazon,Swansea,Uk
6373,6374,08/10/2015,BP,SAVE THE CHANGE,0.32,,8857.28,Savings,Swansea,Uk
6374,6375,07/10/2015,DEB,Amazon UK Marketpl,13.99,,8857.6,Amazon,Swansea,Uk
6375,6376,07/10/2015,DEB,Amazon UK Marketpl,4.69,,8871.59,Amazon,Swansea,Uk
6376,6377,07/10/2015,CHQ,42,418.0,,8876.28,Cash,Swansea,Uk
6377,6378,07/10/2015,BP,SAVE THE CHANGE,0.74,,9294.28,Savings,Swansea,Uk
6378,6379,06/10/2015,DEB,ITUNES.COM/BILL,3.99,,9295.02,Bills,Swansea,Uk
6379,6380,06/10/2015,DEB,Amazon UK Marketpl,1.27,,9299.01,Amazon,Swansea,Uk
6380,6381,06/10/2015,BP,SAVE THE CHANGE,2.01,,9300.28,Savings,Swansea,Uk
6381,6382,05/10/2015,DEB,Amazon UK Retail,12.99,,9302.29,Amazon,Swansea,Uk
6382,6383,05/10/2015,DEB,Amazon UK Marketpl,7.98,,9315.28,Amazon,Swansea,Uk
6383,6384,05/10/2015,DEB,Amazon UK Marketpl,7.66,,9323.26,Amazon,Swansea,Uk
6384,6385,05/10/2015,DEB,Amazon UK Marketpl,6.95,,9330.92,Amazon,Swansea,Uk
6385,6386,05/10/2015,DEB,Amazon UK Marketpl,6.95,,9337.87,Amazon,Swansea,Uk
6386,6387,05/10/2015,DEB,Amazon UK Marketpl,6.23,,9344.82,Amazon,Swansea,Uk
6387,6388,05/10/2015,DEB,Amazon UK Marketpl,5.88,,9351.05,Amazon,Swansea,Uk
6388,6389,05/10/2015,DEB,Amazon UK Marketpl,4.35,,9356.93,Amazon,Swansea,Uk
6389,6390,05/10/2015,DD,ASSURANT INTER LTD,35.56,,9361.28,Insurance,Swansea,Uk
6390,6391,05/10/2015,BP,SAVE THE CHANGE,2.5,,9396.84,Savings,Swansea,Uk
6391,6392,02/10/2015,DEB,NATIONAL WESTMINST,1030.0,,9399.34,Mortgage,Swansea,Uk
6392,6393,02/10/2015,DEB,Amazon UK Marketpl,17.16,,10429.34,Amazon,Swansea,Uk
6393,6394,02/10/2015,DEB,Amazon UK Marketpl,11.1,,10446.5,Amazon,Swansea,Uk
6394,6395,02/10/2015,DEB,Amazon UK Marketpl,3.24,,10457.6,Amazon,Swansea,Uk
6395,6396,02/10/2015,CPT,LOYD WALES UNIV SW,50.0,,10460.84,Cash,Swansea,Uk
6396,6397,02/10/2015,BP,SAVE THE CHANGE,0.52,,10510.84,Savings,Swansea,Uk
6397,6398,01/10/2015,FEE,ACCOUNT FEE,9.95,,10511.36,Bills,Swansea,Uk
6398,6399,01/10/2015,,INTEREST (NET),,4.9,10521.31,Interest,Swansea,Uk
6399,6400,01/10/2015,DEB,Amazon UK Retail,17.49,,10516.41,Amazon,Swansea,Uk
6400,6401,01/10/2015,DEB,Amazon UK Retail,14.99,,10533.9,Amazon,Swansea,Uk
6401,6402,01/10/2015,DD,NATWEST BANK,748.13,,10548.89,Mortgage,Swansea,Uk
6402,6403,01/10/2015,DD,CC SWANSEA C.TAX,122.0,,11297.02,Bills,Swansea,Uk
6403,6404,01/10/2015,DD,GOOD ENERGY GAS,43.0,,11419.02,Bills,Swansea,Uk
6404,6405,01/10/2015,DD,DWR CYMRU W WATER,14.5,,11462.02,Bills,Swansea,Uk
6405,6406,01/10/2015,DD,GOOD ENERGY LTD,13.0,,11476.52,Bills,Swansea,Uk
6406,6407,01/10/2015,DD,TV LICENCE MBP,12.12,,11489.52,Bills,Swansea,Uk
6407,6408,01/10/2015,SO,ESAVINGS ACCOUNT,300.0,,11501.64,Savings,Swansea,Uk
6408,6409,01/10/2015,BP,SAVE THE CHANGE,1.01,,11801.64,Savings,Swansea,Uk
6409,6410,30/09/2015,DEB,Amazon UK Marketpl,5.04,,11802.65,Amazon,Swansea,Uk
6410,6411,30/09/2015,DEB,Amazon UK Marketpl,4.95,,11807.69,Amazon,Swansea,Uk
6411,6412,30/09/2015,DD,UNIV & COL UNION,22.37,,11812.64,Services,Swansea,Uk
6412,6413,30/09/2015,BP,SAVE THE CHANGE,0.76,,11835.01,Savings,Swansea,Uk
6413,6414,30/09/2015,BGC,SWANSEA UNIVERSITY,,3043.03,11835.77,Supplementary Income,Swansea,Uk
6414,6415,29/09/2015,DEB,UPLANDS CHIROPRACT,50.0,,8792.74,Health,Swansea,Uk
6415,6416,29/09/2015,DEB,Amazon UK Marketpl,3.24,,8842.74,Amazon,Swansea,Uk
6416,6417,29/09/2015,BP,SAVE THE CHANGE,1.89,,8845.98,Savings,Swansea,Uk
6417,6418,28/09/2015,DEB,Amazon UK Retail,11.34,,8847.87,Amazon,Swansea,Uk
6418,6419,28/09/2015,DEB,CLKBANK*COM_RGEHNH,39.62,,8859.21,,,
6419,6420,28/09/2015,DEB,Amazon Svcs Europe,2.15,,8898.83,Amazon,Swansea,Uk
6420,6421,25/09/2015,CPT,LOYD WALES UNIV SW,50.0,,8900.98,Cash,Swansea,Uk
6421,6422,25/09/2015,BGC,SWANSEA UNIVERSITY,,429.29,8950.98,Supplementary Income,Swansea,Uk
6422,6423,24/09/2015,BP,SAVE THE CHANGE,0.16,,8521.69,Savings,Swansea,Uk
6423,6424,23/09/2015,DEB,Amazon UK Marketpl,0.84,,8521.85,Amazon,Swansea,Uk
6424,6425,22/09/2015,BP,SAVE THE CHANGE,3.73,,8522.69,Savings,Swansea,Uk
6425,6426,21/09/2015,DEB,CYCLECHIC LTD,83.49,,8526.42,Other Shopping,Swansea,Uk
6426,6427,21/09/2015,DEB,AMAZON MKTPLACE PM,15.01,,8609.91,Amazon,Swansea,Uk
6427,6428,21/09/2015,DEB,Amazon UK Marketpl,8.0,,8624.92,Amazon,Swansea,Uk
6428,6429,21/09/2015,DEB,Amazon UK Marketpl,12.96,,8632.92,Amazon,Swansea,Uk
6429,6430,21/09/2015,DEB,Amazon Svcs Europe,39.11,,8645.88,Amazon,Swansea,Uk
6430,6431,21/09/2015,DEB,Amazon UK Marketpl,3.11,,8684.99,Amazon,Swansea,Uk
6431,6432,21/09/2015,DEB,Amazon UK Marketpl,1.59,,8688.1,Amazon,Swansea,Uk
6432,6433,21/09/2015,DD,VIRGIN MEDIA PYMTS,35.45,,8689.69,Bills,Swansea,Uk
6433,6434,21/09/2015,BP,SAVE THE CHANGE,0.51,,8725.14,Savings,Swansea,Uk
6434,6435,18/09/2015,DEB,Amazon UK Retail,5.49,,8725.65,Amazon,Swansea,Uk
6435,6436,16/09/2015,DEB,IBIS BRISTOL TEMPL,110.0,,8731.14,Hotels,Bristol,Uk
6436,6437,16/09/2015,DD,O2,17.41,,8841.14,Other Shopping,Swansea,Uk
6437,6438,09/09/2015,DD,LV LIFE,37.12,,8858.55,Insurance,Swansea,Uk
6438,6439,07/09/2015,DEB,LIFELOADED LTD,,62.83,8895.67,Supplementary Income,Swansea,Uk
6439,6440,07/09/2015,BP,SAVE THE CHANGE,0.45,,8832.84,Savings,Swansea,Uk
6440,6441,04/09/2015,DEB,JS ONLINE GROCERY,152.56,,8833.29,Groceries,Swansea,Uk
6441,6442,04/09/2015,DEB,Amazon UK Retail,5.99,,8985.85,Amazon,Swansea,Uk
6442,6443,04/09/2015,DEB,FGW WEBSALES,94.0,,8991.84,Travel,Bristol,Uk
6443,6444,04/09/2015,BP,SAVE THE CHANGE,0.01,,9085.84,Savings,Swansea,Uk
6444,6445,03/09/2015,DEB,Amazon UK Marketpl,14.99,,9085.85,Amazon,Swansea,Uk
6445,6446,03/09/2015,CHQ,41,375.0,,9100.84,Cash,Swansea,Uk
6446,6447,03/09/2015,DD,ASSURANT INTER LTD,35.59,,9475.84,Insurance,Swansea,Uk
6447,6448,03/09/2015,BP,SAVE THE CHANGE,2.31,,9511.43,Savings,Swansea,Uk
6448,6449,02/09/2015,DEB,Amazon UK Marketpl,38.48,,9513.74,Amazon,Swansea,Uk
6449,6450,02/09/2015,DEB,Amazon UK Retail,20.17,,9552.22,Amazon,Swansea,Uk
6450,6451,02/09/2015,DEB,Amazon UK Marketpl,6.53,,9572.39,Amazon,Swansea,Uk
6451,6452,02/09/2015,DEB,NON-STG PURCH FEE,1.0,,9578.92,Others,Swansea,Uk
6452,6453,02/09/2015,DEB,NON-STG TRANS FEE,1.86,,9579.92,Others,Swansea,Uk
6453,6454,02/09/2015,DEB,LIFELOADED LTD,62.51,,9581.78,,Swansea,Uk
6454,6455,02/09/2015,BP,SAVE THE CHANGE,0.53,,9644.29,Savings,Swansea,Uk
6455,6456,01/09/2015,FEE,ACCOUNT FEE,9.95,,9644.82,Bills,Swansea,Uk
6456,6457,01/09/2015,,INTEREST (NET),,4.74,9654.77,Interest,Swansea,Uk
6457,6458,01/09/2015,DEB,EASYJET   000EPK,497.96,,9650.03,Travel,,
6458,6459,01/09/2015,DEB,Amazon UK Marketpl,5.51,,10147.99,Amazon,Swansea,Uk
6459,6460,01/09/2015,DD,NATWEST BANK,748.13,,10153.5,Mortgage,Swansea,Uk
6460,6461,01/09/2015,DD,CC SWANSEA C.TAX,122.0,,10901.63,Bills,Swansea,Uk
6461,6462,01/09/2015,DD,GOOD ENERGY GAS,43.0,,11023.63,Bills,Swansea,Uk
6462,6463,01/09/2015,DD,DWR CYMRU W WATER,14.5,,11066.63,Bills,Swansea,Uk
6463,6464,01/09/2015,DD,GOOD ENERGY LTD,13.0,,11081.13,Bills,Swansea,Uk
6464,6465,01/09/2015,DD,TV LICENCE MBP,12.12,,11094.13,Bills,Swansea,Uk
6465,6466,01/09/2015,SO,ESAVINGS ACCOUNT,300.0,,11106.25,Savings,Swansea,Uk
6466,6467,01/09/2015,BP,SAVE THE CHANGE,1.61,,11406.25,Savings,Swansea,Uk
6467,6468,28/08/2015,DEB,Amazon UK Marketpl,12.42,,11407.86,Amazon,Swansea,Uk
6468,6469,28/08/2015,DEB,Amazon UK Retail,11.2,,11420.28,Amazon,Swansea,Uk
6469,6470,28/08/2015,DEB,Amazon Svcs Europe,2.77,,11431.48,Amazon,Swansea,Uk
6470,6471,28/08/2015,CPT,LOYD WALES UNIV SW,30.0,,11434.25,Cash,Swansea,Uk
6471,6472,28/08/2015,DD,UNIV & COL UNION,22.37,,11464.25,Services,Swansea,Uk
6472,6473,28/08/2015,BP,SAVE THE CHANGE,0.06,,11486.62,Savings,Swansea,Uk
6473,6474,28/08/2015,BGC,SWANSEA UNIVERSITY,,3043.03,11486.68,Supplementary Income,Swansea,Uk
6474,6475,27/08/2015,DEB,Amazon UK Marketpl,16.99,,8443.65,Amazon,Swansea,Uk
6475,6476,27/08/2015,DEB,Amazon Svcs Europe,2.95,,8460.64,Amazon,Swansea,Uk
6476,6477,26/08/2015,CPT,LOYD WALES UNIV SW,30.0,,8463.59,Cash,Swansea,Uk
6477,6478,26/08/2015,BP,SAVE THE CHANGE,0.44,,8493.59,Savings,Swansea,Uk
6478,6479,25/08/2015,DEB,Amazon UK Marketpl,1.56,,8494.03,Amazon,Swansea,Uk
6479,6480,25/08/2015,BP,SAVE THE CHANGE,0.4,,8495.59,Savings,Swansea,Uk
6480,6481,24/08/2015,DEB,ARRIVA TRAINS WALE,17.6,,8495.99,Travel,,
6481,6482,24/08/2015,CPT,LOYD SWANSEA UNIVE,70.0,,8513.59,Cash,Swansea,Uk
6482,6483,24/08/2015,BP,SAVE THE CHANGE,1.15,,8583.59,Savings,Swansea,Uk
6483,6484,24/08/2015,FPO,ALAN HOLLAND,140.0,,8584.74,Services,Swansea,Uk
6484,6485,21/08/2015,DEB,BIG SLEEP HOTEL,45.0,,8724.74,Hotels,Cardiff,Uk
6485,6486,21/08/2015,DEB,ARRIVA TRAINS WALE,17.6,,8769.74,Travel,,
6486,6487,21/08/2015,DEB,Amazon Svcs Europe,5.25,,8787.34,Amazon,Swansea,Uk
6487,6488,21/08/2015,DD,VIRGIN MEDIA PYMTS,27.78,,8792.59,Bills,Nottingham,Uk
6488,6489,21/08/2015,BP,SAVE THE CHANGE,0.52,,8820.37,Savings,Swansea,Uk
6489,6490,20/08/2015,DEB,Amazon UK Marketpl,7.99,,8820.89,Amazon,Swansea,Uk
6490,6491,20/08/2015,DEB,Amazon UK Retail,3.49,,8828.88,Amazon,Swansea,Uk
6491,6492,20/08/2015,BP,SAVE THE CHANGE,0.8,,8832.37,Savings,Swansea,Uk
6492,6493,19/08/2015,DEB,Amazon UK Marketpl,9.2,,8833.17,Amazon,Swansea,Uk
6493,6494,19/08/2015,BP,SAVE THE CHANGE,0.78,,8842.37,Savings,Swansea,Uk
6494,6495,18/08/2015,DEB,Amazon UK Marketpl,13.25,,8843.15,Amazon,Swansea,Uk
6495,6496,18/08/2015,DEB,Amazon UK Marketpl,8.98,,8856.4,Amazon,Swansea,Uk
6496,6497,18/08/2015,DEB,Amazon Svcs Europe,5.99,,8865.38,Amazon,Swansea,Uk
6497,6498,18/08/2015,BP,SAVE THE CHANGE,2.37,,8871.37,Savings,Swansea,Uk
6498,6499,17/08/2015,DEB,ISTANBUL RESTAURAN,56.3,,8873.74,Dine Out,Nottingham,Uk
6499,6500,17/08/2015,DEB,Amazon UK Retail,3.0,,8930.04,Amazon,Swansea,Uk
6500,6501,17/08/2015,DEB,Amazon UK Marketpl,4.05,,8933.04,Amazon,Swansea,Uk
6501,6502,17/08/2015,DEB,Amazon UK Marketpl,4.64,,8937.09,Amazon,Swansea,Uk
6502,6503,17/08/2015,DEB,NON-STG PURCH FEE,1.0,,8941.73,Others,Swansea,Uk
6503,6504,17/08/2015,DEB,NON-STG TRANS FEE,0.01,,8942.73,Others,Swansea,Uk
6504,6505,17/08/2015,DEB,LIFELOADED LTD,0.64,,8942.74,,,
6505,6506,17/08/2015,DD,O2,18.61,,8943.38,Other Shopping,Swansea,Uk
6506,6507,17/08/2015,BP,SAVE THE CHANGE,0.05,,8961.99,Savings,Swansea,Uk
6507,6508,14/08/2015,DEB,THE BAYVIEW PUB AN,26.95,,8962.04,Dine Out,Sheerness,Uk
6508,6509,14/08/2015,CPT,LOYD WALES UNIV SW,20.0,,8988.99,Cash,Swansea,Uk
6509,6510,13/08/2015,CPT,LOYD SWANSEA UNIVE,50.0,,9008.99,Cash,Swansea,Uk
6510,6511,13/08/2015,BP,SAVE THE CHANGE,0.41,,9058.99,Savings,Swansea,Uk
6511,6512,12/08/2015,DEB,Amazon UK Marketpl,1.59,,9059.4,Amazon,Swansea,Uk
6512,6513,12/08/2015,BP,SAVE THE CHANGE,0.85,,9060.99,Savings,Swansea,Uk
6513,6514,11/08/2015,DEB,HILTON,29.15,,9061.84,Hotels,,
6514,6515,11/08/2015,DEB,HILTON,238.0,,9090.99,Hotels,,
6515,6516,11/08/2015,BP,SAVE THE CHANGE,2.88,,9328.99,Savings,Swansea,Uk
6516,6517,10/08/2015,DEB,ARRIVA TRAINS WALE,70.5,,9331.87,Travel,,
6517,6518,10/08/2015,DEB,Amazon UK Retail,14.95,,9402.37,Amazon,Swansea,Uk
6518,6519,10/08/2015,DEB,M&S SIMPLY FOOD -,13.41,,9417.32,Groceries,Swansea,Uk
6519,6520,10/08/2015,DEB,Amazon UK Marketpl,4.08,,9430.73,Amazon,Swansea,Uk
6520,6521,10/08/2015,DEB,Amazon UK Retail,7.0,,9434.81,Amazon,Swansea,Uk
6521,6522,10/08/2015,DEB,Amazon Svcs Europe,22.18,,9441.81,Amazon,Swansea,Uk
6522,6523,10/08/2015,DD,LV LIFE,37.12,,9463.99,Insurance,Swansea,Uk
6523,6524,07/08/2015,CPT,LOYD SWANSEA UNIVE,60.0,,9501.11,Cash,Swansea,Uk
6524,6525,07/08/2015,BP,SAVE THE CHANGE,0.62,,9561.11,Savings,Swansea,Uk
6525,6526,06/08/2015,DEB,Amazon UK Retail,20.98,,9561.73,Amazon,Swansea,Uk
6526,6527,06/08/2015,DEB,Amazon UK Retail,18.94,,9582.71,Amazon,Swansea,Uk
6527,6528,06/08/2015,DEB,EXOTICA,15.46,,9601.65,Groceries,Swansea,Uk
6528,6529,06/08/2015,BP,SAVE THE CHANGE,0.98,,9617.11,Savings,Swansea,Uk
6529,6530,05/08/2015,DEB,EXOTICA,21.0,,9618.09,Groceries,Swansea,Uk
6530,6531,05/08/2015,DEB,Amazon UK Marketpl,5.99,,9639.09,Amazon,Swansea,Uk
6531,6532,05/08/2015,DEB,Amazon UK Marketpl,5.15,,9645.08,Amazon,Swansea,Uk
6532,6533,05/08/2015,DEB,Amazon UK Marketpl,1.88,,9650.23,Amazon,Swansea,Uk
6533,6534,05/08/2015,BP,SAVE THE CHANGE,1.07,,9652.11,Savings,Swansea,Uk
6534,6535,04/08/2015,DEB,Amazon UK Retail,7.13,,9653.18,Amazon,Swansea,Uk
6535,6536,04/08/2015,DEB,Amazon UK Marketpl,2.8,,9660.31,Amazon,Swansea,Uk
6536,6537,04/08/2015,BP,SAVE THE CHANGE,0.01,,9663.11,Savings,Swansea,Uk
6537,6538,03/08/2015,FEE,ACCOUNT FEE,9.95,,9663.12,Bills,Swansea,Uk
6538,6539,03/08/2015,,INTEREST (NET),,5.4,9673.07,Interest,Swansea,Uk
6539,6540,03/08/2015,DEB,Amazon Svcs Europe,89.99,,9667.67,Amazon,Swansea,Uk
6540,6541,03/08/2015,CPT,LOYD WALES UNIV SW,50.0,,9757.66,Cash,Swansea,Uk
6541,6542,03/08/2015,DD,NATWEST BANK,748.13,,9807.66,Mortgage,Swansea,Uk
6542,6543,03/08/2015,DD,CC SWANSEA C.TAX,122.0,,10555.79,Bills,Swansea,Uk
6543,6544,03/08/2015,DD,GOOD ENERGY GAS,71.0,,10677.79,Bills,Swansea,Uk
6544,6545,03/08/2015,DD,GOOD ENERGY LTD,43.0,,10748.79,Bills,Swansea,Uk
6545,6546,03/08/2015,DD,ASSURANT INTER LTD,35.56,,10791.79,Insurance,Swansea,Uk
6546,6547,03/08/2015,DD,DWR CYMRU W WATER,22.5,,10827.35,Bills,Swansea,Uk
6547,6548,03/08/2015,DD,TV LICENCE MBP,12.12,,10849.85,Bills,Swansea,Uk
6548,6549,03/08/2015,SO,ESAVINGS ACCOUNT,300.0,,10861.97,Savings,Swansea,Uk
6549,6550,03/08/2015,BP,SAVE THE CHANGE,0.5,,11161.97,Savings,Swansea,Uk
6550,6551,03/08/2015,BGC,STFC AP,,585.29,11162.47,Supplementary Income,Swansea,Uk
6551,6552,31/07/2015,DEB,ARRIVA TRAINS WALE,33.5,,10577.18,Travel,,
6552,6553,31/07/2015,DD,UNIV & COL UNION,22.37,,10610.68,Services,Swansea,Uk
6553,6554,31/07/2015,BP,SAVE THE CHANGE,0.2,,10633.05,Savings,Swansea,Uk
6554,6555,31/07/2015,BGC,SWANSEA UNIVERSITY,,3042.63,10633.25,Supplementary Income,Swansea,Uk
6555,6556,31/07/2015,BGC,SWANSEA UNIVERSITY,,503.36,7590.62,Supplementary Income,Swansea,Uk
6556,6557,30/07/2015,DEB,Amazon UK Marketpl,6.8,,7087.26,Amazon,Swansea,Uk
6557,6558,30/07/2015,BP,SAVE THE CHANGE,0.52,,7094.06,Savings,Swansea,Uk
6558,6559,29/07/2015,DEB,Amazon UK Marketpl,17.94,,7094.58,Amazon,Swansea,Uk
6559,6560,29/07/2015,DEB,Amazon Svcs Europe,4.54,,7112.52,Amazon,Swansea,Uk
6560,6561,29/07/2015,CPT,LOYD SWANSEA UNIVE,70.0,,7117.06,Cash,Swansea,Uk
6561,6562,29/07/2015,BP,SAVE THE CHANGE,0.51,,7187.06,Savings,Swansea,Uk
6562,6563,28/07/2015,DEB,Amazon Svcs Europe,5.49,,7187.57,Amazon,Swansea,Uk
6563,6564,28/07/2015,BP,SAVE THE CHANGE,1.1,,7193.06,Savings,Swansea,Uk
6564,6565,27/07/2015,DEB,Amazon UK Marketpl,6.39,,7194.16,Amazon,Swansea,Uk
6565,6566,27/07/2015,DEB,JS ONLINE GROCERY,316.51,,7200.55,Groceries,Swansea,Uk
6566,6567,27/07/2015,FPO,ALAN HOLLAND,1000.0,,7517.06,Services,Swansea,Uk
